Thomas McPeek is the exhibitor of what types of events	expo|competition|conference|demo_day|networking
Alexander Gedranovich is the exhibitor of what types of events	competition|conference
Olga Chumakova is the exhibitor of what types of events	conference|networking
Vasile Granaci is the exhibitor of what types of events	seminar|conference|expo
Jen Quinlan is the exhibitor of what types of events	conference
Roland Dubois is the exhibitor of what types of events	expo
Marko Jotić is the exhibitor of what types of events	conference
Maria Xinhe Shen is the exhibitor of what types of events	competition|demo_day
Ted Moskovitz is the exhibitor of what types of events	conference
Anastasia Sartan is the exhibitor of what types of events	meetup|conference|networking|demo_day
Robert Brevelle is the exhibitor of what types of events	seminar|expo|meetup|festival|conference|hackathon|demo_day|networking
Francois Mathieu is the exhibitor of what types of events	festival|conference|expo
Iyan Vonix is the exhibitor of what types of events	competition
Michael Barbine is the exhibitor of what types of events	conference
Brian Bodik is the exhibitor of what types of events	conference
Gerhard Fettweis is the exhibitor of what types of events	conference
Francisco Toledo is the exhibitor of what types of events	conference
Yanik Guillemette is the exhibitor of what types of events	conference
Ian Rowan is the exhibitor of what types of events	conference
Hisham Badawi is the exhibitor of what types of events	expo
Khaled Kteily is the exhibitor of what types of events	meetup|conference
Luigi Clivati is the exhibitor of what types of events	conference|networking
Ricard Julia is the exhibitor of what types of events	conference|expo
Joanne Dai is the exhibitor of what types of events	expo|competition|meetup|conference|hackathon|networking
Oleksii Tronchuk is the exhibitor of what types of events	conference
Jack Bistricer is the exhibitor of what types of events	conference|virtual
Alex Chan is the exhibitor of what types of events	competition|conference|festival
Ralph Baddour is the exhibitor of what types of events	conference
Harsh Rajnikant Patel is the exhibitor of what types of events	competition|networking|conference|hackathon
Ilayda Buyukdogan is the exhibitor of what types of events	conference
Morgan Regnier is the exhibitor of what types of events	expo|meetup|conference|hackathon|networking
Dimitri Mikhalchuk is the exhibitor of what types of events	conference|expo
Brendan Carruthers is the exhibitor of what types of events	meetup|conference|networking|expo
Lorenzo Lurati is the exhibitor of what types of events	meetup|conference|networking|expo
Igor Kostyuchenok is the exhibitor of what types of events	conference
Maggie Solé is the exhibitor of what types of events	conference|expo
Phillip LaBrasca is the exhibitor of what types of events	meetup|conference
Devin Davie is the exhibitor of what types of events	seminar|conference
Alex Kuhle is the exhibitor of what types of events	conference
Ajay Borra is the exhibitor of what types of events	conference
Alex Thibault is the exhibitor of what types of events	conference
Aleksander Uraksin is the exhibitor of what types of events	conference|expo
Colin James Mckenzie is the exhibitor of what types of events	conference
Alister Toma is the exhibitor of what types of events	conference
Gleb Davidyuk is the exhibitor of what types of events	conference
Abeer Raza is the exhibitor of what types of events	networking
Sinan Odak is the exhibitor of what types of events	conference
Michael Tan is the exhibitor of what types of events	competition|meetup|conference|hackathon|demo_day
Emre Savaş is the exhibitor of what types of events	meetup|conference
Nils Ziehn is the exhibitor of what types of events	meetup|conference|networking|expo
Dudi Berkowitz Chicago is the exhibitor of what types of events	conference|networking|expo
Taylor McCaslin is the exhibitor of what types of events	conference|networking
Paulo Nunes is the exhibitor of what types of events	meetup
Ulf F. Loetschert is the exhibitor of what types of events	seminar|conference
Ryan Lee is the exhibitor of what types of events	conference
Joe Blackburn is the exhibitor of what types of events	conference
Barton Shields is the exhibitor of what types of events	meetup|conference|expo
Chad Schumacher is the exhibitor of what types of events	demo_day|conference|networking|expo
Freddy Elturk is the exhibitor of what types of events	conference
Matthew Jordan is the exhibitor of what types of events	conference|expo
Axel GALLIAN is the exhibitor of what types of events	expo|meetup|demo_day|conference|networking
Sidharth Sogani is the exhibitor of what types of events	seminar|conference
Vanda Seidelova is the exhibitor of what types of events	meetup
Nicolas Payen is the exhibitor of what types of events	conference
David DeRemer is the exhibitor of what types of events	conference
Alexander Wesley is the exhibitor of what types of events	competition|meetup|networking
Avi Stoller is the exhibitor of what types of events	expo
Onurcan Eki is the exhibitor of what types of events	meetup|conference
Chamath Kirinde is the exhibitor of what types of events	festival|conference|expo
Jan Brzezek is the exhibitor of what types of events	conference|expo
Erin Wold is the exhibitor of what types of events	meetup|conference|networking|demo_day
Raji Wahidy is the exhibitor of what types of events	conference
Tamas Vasile is the exhibitor of what types of events	conference
Alberto Barbo is the exhibitor of what types of events	conference
Sameer Ahirrao is the exhibitor of what types of events	conference
Daniel Souza Covacich is the exhibitor of what types of events	meetup|conference|expo
Henrik Gebbing is the exhibitor of what types of events	conference|festival
Piotr Kocel is the exhibitor of what types of events	meetup|conference|networking|expo
Olawale Kudus is the exhibitor of what types of events	conference
Brittney Mickel is the exhibitor of what types of events	conference
Prashant Kumar is the exhibitor of what types of events	conference
Ergin Eroglu is the exhibitor of what types of events	conference
Ben Fenster is the exhibitor of what types of events	conference
Martin Zahumensky is the exhibitor of what types of events	conference
Aliya Grig is the exhibitor of what types of events	meetup|networking|expo
Siddharth Somasundaran is the exhibitor of what types of events	conference
Furkan KAMACI is the exhibitor of what types of events	conference
Erick Brimen is the exhibitor of what types of events	conference
Iana Mykhailenko is the exhibitor of what types of events	conference|expo
Eddie Sit is the exhibitor of what types of events	conference
Rob Haney is the exhibitor of what types of events	competition|meetup|networking
Joseph Rutakangwa is the exhibitor of what types of events	meetup|conference
Kimberly Salzer is the exhibitor of what types of events	expo
Armen Poghosyan is the exhibitor of what types of events	conference|expo
Mr. Chetan Naik is the exhibitor of what types of events	conference
Abe Mashinsky is the exhibitor of what types of events	meetup|expo
FREDERIC CERON SOLANO is the exhibitor of what types of events	expo
Yecheskel Schwab is the exhibitor of what types of events	conference|expo
Al Serino is the exhibitor of what types of events	conference|networking|expo
