Mario Letelier invested in which organizations	Buscapé@40ab5
Kevin Wall invested in which organizations	Kiosked@e3a2d
Joanne Wilson invested in which organizations	Lover.ly@ccad6
Justin Mateen invested in which organizations	Mynaric@516a7
Franciscus Zheng invested in which organizations	PopIt_Snack@521bc
Mike Shim invested in which organizations	DigiSure@59044
lLammar Perfect invested in which organizations	Ammar_Lexie@32b57
Jennifer Wyatt invested in which organizations	GigWrks@02dc4
Alejandro Revecco invested in which organizations	UHOMIE@d99de
Glen Kacher invested in which organizations	SignalRank_Corporation@ff1ec
Shogo Kawada invested in which organizations	Yappli@847c7
L. Daniel Wilson invested in which organizations	Hölmetrics@3efcb
Joshua Browder invested in which organizations	Wander@f6a24
Sandy Purcell invested in which organizations	AudioEye@7b5c2
Lisa Gansky invested in which organizations	Trove@4afc9
Pettersom Paiva invested in which organizations	Super_Troupers@f52f5
Robert Stavis invested in which organizations	LNTS@8e98a
Hunter Walk invested in which organizations	Assembly@6ac60
Antonis Valamontes invested in which organizations	Geopay.me@05134
Betsalel Elfassy invested in which organizations	Brands_Capital@c49e7
Amit Patni invested in which organizations	Wellness_Forever_Medicare@c5515
Ido Leffler invested in which organizations	Omni@563a0
Shane Donald invested in which organizations	Frontline_Investments_India@204cc
Edward Lando invested in which organizations	Pronto@2b843
Michael Maximilian Sepp invested in which organizations	Befundo.com@39d49
Konstantin Terentiev invested in which organizations	Befundo.com@39d49
Brian Craig invested in which organizations	Nanoprecise_Sci_Corp@7f4b9
Fulvio Kaminski Massaro invested in which organizations	Auto_Arremate@743cf
Noam Kaiser invested in which organizations	Vendia@46273
Roy Vann invested in which organizations	Zenu_App_LLC@c1c3d
Tom Williams invested in which organizations	Huckleberry_Labs@c0a2b
Taavet Hinrikus invested in which organizations	Pactum@16283
Michael Kleindl invested in which organizations	Mediasmart@7d9c4
Domenico Loprieno invested in which organizations	Patreon@8f08c
Chris Pronger invested in which organizations	LockerDome@d8e15
Ali Rasoul invested in which organizations	Ali_Rasoul_LTD@b28fa
Kaj Hed invested in which organizations	Kiosked@e3a2d
Oksana Stowe invested in which organizations	LVNDR_Health@be04c
Oleg Krot invested in which organizations	P2Pseller@af164
Lip-Bu Tan invested in which organizations	SignalRank_Corporation@ff1ec
Jenny Rooke invested in which organizations	Zephyrus_Biosciences@ef4fb|Zymergen@33df5
Sudheer Mareddi invested in which organizations	Ebutor@10257
Morten Lund invested in which organizations	Itembase@59603
Noel Zeh invested in which organizations	iPrice_Group@5d739|Packlink@6e0f7
Michael Burry invested in which organizations	Eyeona@2756e
Scott Banister invested in which organizations	Dyspatch@b9869
Arul Murugan invested in which organizations	Musicasa@99a5a
Joshua Weinreich invested in which organizations	brrr°@08d5f
Patrick Zeeuw invested in which organizations	HIGH_PROFILE_CLUB@ba0f0
Pavel Glushenkov invested in which organizations	CrowdSystems@9ede2|Level_Travel@5650f
Sky Dayton invested in which organizations	Pipe@4dc82|Diffbot@c6d99
William Kirby invested in which organizations	Internet_Distribution_Systems_(IDS_LLC.)@3f7b5
sachin kumar invested in which organizations	Taksh_it_solutions_pvt_ltd@7473a
Todd Corenson invested in which organizations	HelixNano@a5319
Devdutt Yellurkar invested in which organizations	Cratejoy@f1911
Bav Kong invested in which organizations	Music_Lover@60c72
Randall Milch invested in which organizations	Cyber_Innovative_Technologies@bfe9e
Allen Miner invested in which organizations	Salesforce@c3340
Joe Lacob invested in which organizations	imoji@071d4
Abdul Sh invested in which organizations	Graphenizer@900c1
Nadav Rosenberg invested in which organizations	Biomage@21b9b
Jeff Weiner invested in which organizations	Cloud_of_Goods@9567b
Carolyn Bivens invested in which organizations	Quantason@d1bd7
Amrut Kamani invested in which organizations	Teksun_Inc@2b416
Muhammad Yousaf Iqbal invested in which organizations	Dawai_At_Door@9962f
Chhang Bunthorn invested in which organizations	Music_Lover@60c72
P. Addo-Nyarko invested in which organizations	PISTIS_And_Associates@659ab
Cliff Holekamp invested in which organizations	SoMoLend@a620f|DealCloud@59c16|FinLocker@23c31|Noonlight@d6a4b|BenchmarkONE@11659|Clever_Real_Estate@7e5bc|PlanGap@da7ee|TopOPPS@752f5|LockerDome@d8e15|Avail@ec259|Reconstruct@ec1c7|Curate@a979f
Jonathan Wu invested in which organizations	Website_Pros@3452a
Tuncay TUNÇKOL invested in which organizations	TUNÇKOL_MAKİNA@34ed2|TUNÇKOL@2ac7a|COOL_WATCH@a05c7
Lynn-Ann Gries invested in which organizations	OndeCare@e1cb2
Michael Marks invested in which organizations	Trove@4afc9
Kaare Danielsen invested in which organizations	Firmafon@330ab
Brittney Mickel invested in which organizations	Gain_Hash@bf48d|Jointer@7e1ea|Geoloqi@15f92
Alex Lawton invested in which organizations	BEDROCK_-_Data_by_Design@3ad26
Bernard Liautaud invested in which organizations	Dashlane@360f1
Murat Abdrakhmanov invested in which organizations	Influ2@c8321
Ira Lubert invested in which organizations	Houwzer@8a9e3
Julius Koehler invested in which organizations	Sdui@ef0e7
Thet Kyaw Linn invested in which organizations	Myanmar_Digital_Solutions@11e7f
Jazeer Jamal invested in which organizations	GrowValley@16742
Bob Saunders invested in which organizations	nQ_Medical@d8bb2
Simon Slamka invested in which organizations	Ongakken@0fe39
Andrey Azarov invested in which organizations	Laoshi@4eaa8
John Curtis invested in which organizations	Britcan_Media_Limited@42960
Mika Salmi invested in which organizations	Inkd.com@5f8ef
Justin Waldron invested in which organizations	Poliglota@1f1fc
Douglas Teitelbaum invested in which organizations	NJOY@fb0e9
Sophia Collier invested in which organizations	Pronto@2b843
Brian Ross invested in which organizations	WTI_(Western_Telematic_Inc)@fbbbb
Matt Paff invested in which organizations	vSure@2bca8
Mathias Eklof invested in which organizations	Let's_Enhance@15cd9
Josh Mailman invested in which organizations	Grove_Collaborative@9787a
Amin Chaar invested in which organizations	ecadema_-_Online_Learning@5848d
Jim Young invested in which organizations	Init.ai@092c6
Bruce A. Peacock invested in which organizations	Interius_BioTherapeutics@52525
Gil Rabbi invested in which organizations	Storycards@667ae
Natasha Apeadjei-Duodu invested in which organizations	SamBoad_Business_Group_Limited@ecdb9
Rahul Mishra invested in which organizations	ecadema_-_Online_Learning@5848d
Stani Kulechov invested in which organizations	Opium_Protocol@9b1dc
