Game Insight is the sspeaker of events in which countries	seminar|expo|meetup|conference|networking
Net-ng is the sspeaker of events in which countries	conference
Intesa Sanpaolo is the sspeaker of events in which countries	meetup|festival|conference|demo_day|networking
NDC is the sspeaker of events in which countries	conference
Continuity Logic is the sspeaker of events in which countries	conference
Agorapulse is the sspeaker of events in which countries	conference
Replicon is the sspeaker of events in which countries	conference
Red Panthers is the sspeaker of events in which countries	seminar|conference
Venture Lab is the sspeaker of events in which countries	competition|conference|networking|expo
NCSolutions is the sspeaker of events in which countries	meetup|class|conference|networking
Clariant is the sspeaker of events in which countries	conference
SCIEX is the sspeaker of events in which countries	conference
Source Photonics is the sspeaker of events in which countries	conference
BPF is the sspeaker of events in which countries	expo
Kroll Ontrack is the sspeaker of events in which countries	conference
Ireland China Science & Technology Association is the sspeaker of events in which countries	conference
REACH mastery is the sspeaker of events in which countries	meetup|conference
InternetNZ is the sspeaker of events in which countries	seminar|conference
MaxPoint Interactive is the sspeaker of events in which countries	meetup|conference|networking
Women In Marketing is the sspeaker of events in which countries	conference|festival
SS&C Technologies is the sspeaker of events in which countries	conference
Rajasthan Venture Capital Fund is the sspeaker of events in which countries	conference
LeapYear Technologies is the sspeaker of events in which countries	conference
WorkFusion is the sspeaker of events in which countries	conference|networking
CloudNatix is the sspeaker of events in which countries	conference
Kinoma is the sspeaker of events in which countries	conference
DAS UK Group is the sspeaker of events in which countries	demo_day
Single Grain is the sspeaker of events in which countries	conference
InvestingChannel, Inc. is the sspeaker of events in which countries	conference
First Fidelity Brokerage is the sspeaker of events in which countries	conference
HWZ Zurich University of Applied Sciences in Business Administration is the sspeaker of events in which countries	conference
Sportdec is the sspeaker of events in which countries	conference
Initial State Technologies is the sspeaker of events in which countries	conference|expo
Rally Health is the sspeaker of events in which countries	conference
Innovation Norway is the sspeaker of events in which countries	meetup|conference|festival
Fundação Lemann is the sspeaker of events in which countries	conference
EdgeCore is the sspeaker of events in which countries	webinar|networking
Russian Association of Marketing Services is the sspeaker of events in which countries	conference|expo
Cabling Installation and Maintenance is the sspeaker of events in which countries	conference|expo
Sergeant Laboratories is the sspeaker of events in which countries	conference
Remoters is the sspeaker of events in which countries	meetup|conference|networking|expo
Party Rent Group is the sspeaker of events in which countries	expo|competition|festival|conference|networking
Morphisec is the sspeaker of events in which countries	conference
tray.io is the sspeaker of events in which countries	conference|seminar|meetup|expo
DiscoverOrg is the sspeaker of events in which countries	meetup|conference|networking
TopLine Comms is the sspeaker of events in which countries	conference
JumpCloud is the sspeaker of events in which countries	conference|networking
Moldova IT Park is the sspeaker of events in which countries	festival
Chute is the sspeaker of events in which countries	seminar|competition|conference|demo_day|networking
Dunmore is the sspeaker of events in which countries	seminar|conference
SV Insight is the sspeaker of events in which countries	conference|networking
Avfoil is the sspeaker of events in which countries	conference
Brookfield Renewable Partners is the sspeaker of events in which countries	conference|expo
Inexto is the sspeaker of events in which countries	conference
Lyons Consulting Group is the sspeaker of events in which countries	meetup|festival|conference|expo
ECS Federal is the sspeaker of events in which countries	conference
Futurestay is the sspeaker of events in which countries	meetup|conference|networking
DigiPippi is the sspeaker of events in which countries	conference
Spotscale is the sspeaker of events in which countries	conference
Texas Instruments is the sspeaker of events in which countries	meetup|conference|expo
Movidius is the sspeaker of events in which countries	conference|expo
Macadamian Technologies is the sspeaker of events in which countries	meetup|seminar|conference|networking
Keppler Speakers is the sspeaker of events in which countries	conference
ZPE Systems, Inc. is the sspeaker of events in which countries	conference
Medius is the sspeaker of events in which countries	conference
Neptune.io is the sspeaker of events in which countries	conference
Blackstone LaunchPad is the sspeaker of events in which countries	conference|hackathon|demo_day
Anlyz is the sspeaker of events in which countries	conference
IET is the sspeaker of events in which countries	conference|networking
GetJenny is the sspeaker of events in which countries	competition|conference
Thinkst Canary is the sspeaker of events in which countries	conference
CenturyLink Technology Solutions is the sspeaker of events in which countries	conference|expo
Cybeats Technologies is the sspeaker of events in which countries	conference
Ascendas is the sspeaker of events in which countries	conference|festival
iTernity is the sspeaker of events in which countries	conference
Micro Strategies, Inc. is the sspeaker of events in which countries	conference
Acuity Market Intelligence is the sspeaker of events in which countries	networking|conference|expo|demo_day
Hyperight is the sspeaker of events in which countries	conference|expo
Digify is the sspeaker of events in which countries	meetup|conference|hackathon|expo
Grafana Labs is the sspeaker of events in which countries	conference
DO Global is the sspeaker of events in which countries	conference
Bolt is the sspeaker of events in which countries	conference
WebID Solutions is the sspeaker of events in which countries	conference
Hoory is the sspeaker of events in which countries	meetup
Experts Exchange is the sspeaker of events in which countries	expo|festival|conference|hackathon|networking
Hushang Caifu is the sspeaker of events in which countries	conference|expo
Encom is the sspeaker of events in which countries	conference
Crafter Software is the sspeaker of events in which countries	conference
Datahug is the sspeaker of events in which countries	seminar|expo|meetup|conference|networking
NASDAQ Entrepreneurial Center is the sspeaker of events in which countries	competition|conference
Finans Danmark is the sspeaker of events in which countries	conference
Keybank is the sspeaker of events in which countries	seminar|expo|competition|conference|networking
JustAPIs is the sspeaker of events in which countries	expo|festival|conference|hackathon|networking
Aramark is the sspeaker of events in which countries	conference|expo
SIMalliance is the sspeaker of events in which countries	conference|networking|expo
Vertafore is the sspeaker of events in which countries	conference
CentreStack is the sspeaker of events in which countries	conference|networking
Asplundh Construction is the sspeaker of events in which countries	conference
Banca Transilvania is the sspeaker of events in which countries	conference
fearless is the sspeaker of events in which countries	conference
