Abdelhak Bahri was the lead investor of what types of funding rounds	pre_seed
Harvinder Singh Bhatia was the lead investor of what types of funding rounds	angel
Louis Beryl was the lead investor of what types of funding rounds	seed
Ira Bell was the lead investor of what types of funding rounds	seed|undisclosed
Mohamed Aboshanab was the lead investor of what types of funding rounds	pre_seed
Chris Burggraeve was the lead investor of what types of funding rounds	angel
Nick Stenning was the lead investor of what types of funding rounds	seed
Tom Huseby was the lead investor of what types of funding rounds	series_b
Eric Janszen was the lead investor of what types of funding rounds	seed
Nevzat Aydın was the lead investor of what types of funding rounds	angel
Kishore Reddy Tera was the lead investor of what types of funding rounds	angel
Rafael Ortiz was the lead investor of what types of funding rounds	angel
Oscar Gill was the lead investor of what types of funding rounds	pre_seed
Frank Westermann was the lead investor of what types of funding rounds	pre_seed
Saki Georgiadis was the lead investor of what types of funding rounds	pre_seed
Tuvia Barak was the lead investor of what types of funding rounds	seed
Michael Spencer was the lead investor of what types of funding rounds	seed|series_b|undisclosed
Tom Lee was the lead investor of what types of funding rounds	post_ipo_debt
Peter Jones was the lead investor of what types of funding rounds	seed
Dan Gilbert was the lead investor of what types of funding rounds	series_a|series_b
Henrik Sparup was the lead investor of what types of funding rounds	pre_seed
Kris Singh was the lead investor of what types of funding rounds	seed
Gary Hevelone was the lead investor of what types of funding rounds	convertible_note
Chris Larsen was the lead investor of what types of funding rounds	seed
Azar Gurbanov was the lead investor of what types of funding rounds	series_a
Michael Crowe was the lead investor of what types of funding rounds	series_a
Ivan Chebotaiev was the lead investor of what types of funding rounds	pre_seed|seed|series_a
Musaab Hakami was the lead investor of what types of funding rounds	pre_seed
Andy Bonsall was the lead investor of what types of funding rounds	equity_crowdfunding
David Horowitz was the lead investor of what types of funding rounds	seed
Philipp Lahm was the lead investor of what types of funding rounds	seed
Efim Kogan was the lead investor of what types of funding rounds	pre_seed
Mohammed Abdullah A Al Baadi was the lead investor of what types of funding rounds	seed
Hemant Joshi was the lead investor of what types of funding rounds	pre_seed
Ronald Rock was the lead investor of what types of funding rounds	series_b
Toru Shimada was the lead investor of what types of funding rounds	seed|angel
Josh Hannah was the lead investor of what types of funding rounds	convertible_note
Yoshiteru Akita was the lead investor of what types of funding rounds	angel
Eyal Gura was the lead investor of what types of funding rounds	series_b
Konstantin Terentiev was the lead investor of what types of funding rounds	series_a
Rob Dobson was the lead investor of what types of funding rounds	angel
Alain Garner was the lead investor of what types of funding rounds	series_b
Abhishek Agarwal was the lead investor of what types of funding rounds	seed
Peter Thiel was the lead investor of what types of funding rounds	seed|angel|series_a|series_b
Kris Ledel was the lead investor of what types of funding rounds	pre_seed|seed
Stephen Grocott was the lead investor of what types of funding rounds	pre_seed
Eric Schmidt was the lead investor of what types of funding rounds	seed|grant
David Kyte was the lead investor of what types of funding rounds	seed
Daniel Lubetzky was the lead investor of what types of funding rounds	pre_seed
Timothy Biltz was the lead investor of what types of funding rounds	angel
Michael Maximilian Sepp was the lead investor of what types of funding rounds	pre_seed|series_b
Ankit Nagori was the lead investor of what types of funding rounds	angel
Jay Minkoff was the lead investor of what types of funding rounds	seed
Mohsin Ali was the lead investor of what types of funding rounds	pre_seed|seed
Charles Yim was the lead investor of what types of funding rounds	seed
Daniel Schulman was the lead investor of what types of funding rounds	seed
Sanjay Uppal was the lead investor of what types of funding rounds	pre_seed|seed
Sanchita Gupta was the lead investor of what types of funding rounds	seed
Emeuric Gleizes was the lead investor of what types of funding rounds	series_a
Malik Mehrose was the lead investor of what types of funding rounds	seed
Arnold Schwarzenegger was the lead investor of what types of funding rounds	pre_seed
Riaz Ladha was the lead investor of what types of funding rounds	seed
Halsey Minor was the lead investor of what types of funding rounds	series_b
Stephen Luczo was the lead investor of what types of funding rounds	series_b
Richelieu Dennis was the lead investor of what types of funding rounds	seed
Jinbo Yao was the lead investor of what types of funding rounds	series_a
Abhay Raj Solanki was the lead investor of what types of funding rounds	series_a
Joe Maristela was the lead investor of what types of funding rounds	angel
Marco Casarin was the lead investor of what types of funding rounds	pre_seed
Kanwaljit Singh was the lead investor of what types of funding rounds	angel|series_a
Ken Leonard was the lead investor of what types of funding rounds	seed|series_a
Shubham Singh was the lead investor of what types of funding rounds	pre_seed
Kent L. Johnson was the lead investor of what types of funding rounds	series_a
Mihai Manole was the lead investor of what types of funding rounds	seed
Mehrdad Piroozram was the lead investor of what types of funding rounds	angel
Vichit Suraphongchai was the lead investor of what types of funding rounds	pre_seed|seed
Andrew Vo was the lead investor of what types of funding rounds	pre_seed
Farooq Oomerbhoy was the lead investor of what types of funding rounds	seed
Vimal Kedia was the lead investor of what types of funding rounds	seed
Kevin Ryan was the lead investor of what types of funding rounds	angel
Shashikant Chaudhary was the lead investor of what types of funding rounds	angel
Cédric Delorme was the lead investor of what types of funding rounds	angel
Abdulaziz Al Loughani was the lead investor of what types of funding rounds	seed
Ilya Nykin was the lead investor of what types of funding rounds	series_a
Ashley Chau was the lead investor of what types of funding rounds	seed
Randy Scott was the lead investor of what types of funding rounds	series_c
Harveen Narulla was the lead investor of what types of funding rounds	seed
Santhosh Gowda was the lead investor of what types of funding rounds	pre_seed
Andrew Garnock was the lead investor of what types of funding rounds	seed
Yu Akasaka was the lead investor of what types of funding rounds	angel
Alexander Hirsch was the lead investor of what types of funding rounds	seed
Purushottam Agrawal was the lead investor of what types of funding rounds	series_a
Ajay Relan was the lead investor of what types of funding rounds	seed
Agustin Iglesias was the lead investor of what types of funding rounds	pre_seed
Prakash Quadras was the lead investor of what types of funding rounds	seed
Jaroslaw Krolewski was the lead investor of what types of funding rounds	undisclosed
Jayant Bokadia was the lead investor of what types of funding rounds	angel
David E. Shaw was the lead investor of what types of funding rounds	series_a
Michael Walrath was the lead investor of what types of funding rounds	series_d
Serge Beck was the lead investor of what types of funding rounds	seed
