Ron Winward is the speaker of what types of events	conference
Jon Bruner is the speaker of what types of events	festival|conference|networking|expo
Ignatius John is the speaker of what types of events	conference
Ekaterina Prasolova-Forland is the speaker of what types of events	conference|expo
Joshua Berns is the speaker of what types of events	conference|networking
Dongsheng Wang is the speaker of what types of events	conference
Marcel Hulsman is the speaker of what types of events	conference
Fabio Benedetti is the speaker of what types of events	conference
Yunus Genes is the speaker of what types of events	conference|networking|expo
Andrew Grinaker is the speaker of what types of events	conference
Daniella Yacobovsky is the speaker of what types of events	conference
Alex Nyahoe is the speaker of what types of events	expo
Yunus Emre Güzer is the speaker of what types of events	competition|conference|networking
Dorota Stopczyk is the speaker of what types of events	conference|expo
Mike Landry is the speaker of what types of events	conference|networking|expo
Suzan LeVine is the speaker of what types of events	meetup|conference|networking|demo_day
Matt Stroud is the speaker of what types of events	expo
Carsten Rossenhövel is the speaker of what types of events	conference|networking|expo
Meredith Haberfeld is the speaker of what types of events	conference|networking
Victoria Gamerman is the speaker of what types of events	meetup|conference
Boris von Bormann is the speaker of what types of events	conference|expo
Mark Curran is the speaker of what types of events	conference
Bratton Riley is the speaker of what types of events	conference
Kate Dunn is the speaker of what types of events	conference
Gaurav Mehta is the speaker of what types of events	seminar|expo|class|conference|networking
Eric Hileman is the speaker of what types of events	conference
Courtney Caldwell is the speaker of what types of events	conference
Kris Bowring is the speaker of what types of events	conference|expo
Erika Alonso is the speaker of what types of events	conference
Åsa Nyström is the speaker of what types of events	conference
Benjamin Snider is the speaker of what types of events	conference
Brigitte Hoyer Gosselink is the speaker of what types of events	conference
Eran Bello is the speaker of what types of events	conference
Kyle Fugere is the speaker of what types of events	conference|networking
Hong Li is the speaker of what types of events	conference
Marta Lopata is the speaker of what types of events	conference|networking
Paul Richardson is the speaker of what types of events	conference
Linda Shomo is the speaker of what types of events	meetup|conference|networking
Fred Muller is the speaker of what types of events	conference
Shailabh Haldule is the speaker of what types of events	conference
Robert Rogers is the speaker of what types of events	conference|expo
Cody Connor is the speaker of what types of events	conference
Fritha Hookway is the speaker of what types of events	conference
Daichi Iwata is the speaker of what types of events	conference
Brent Freeman is the speaker of what types of events	conference
Craig Ramsay is the speaker of what types of events	seminar|conference|expo|demo_day
Kathleen Chaykowski is the speaker of what types of events	conference
Garrett Watumull is the speaker of what types of events	class
Mara Lecocq is the speaker of what types of events	conference|festival
Brian Heimberg is the speaker of what types of events	competition|conference|networking
Olaf Kroll is the speaker of what types of events	conference
Orlan Boston is the speaker of what types of events	conference
Paudie O'Riordan is the speaker of what types of events	conference
Colum Slevin is the speaker of what types of events	conference
Dmitry Jemerov is the speaker of what types of events	conference
Lori McLean is the speaker of what types of events	conference
Madhav Durbha is the speaker of what types of events	conference
George Barrios is the speaker of what types of events	conference
Philip Hübner is the speaker of what types of events	conference
Javier Luiso is the speaker of what types of events	conference|expo
Lee Kushner is the speaker of what types of events	conference
Mladen Milanovic is the speaker of what types of events	conference
Stephen Parente is the speaker of what types of events	conference
Andrej Miklánek is the speaker of what types of events	expo|competition|festival|conference|hackathon
Nicolas Defachel is the speaker of what types of events	conference
Simona Francese is the speaker of what types of events	conference
Alan Murray is the speaker of what types of events	seminar|expo|meetup|festival|conference|networking
Naomi Beckett is the speaker of what types of events	conference|networking|expo
Aimee Miller is the speaker of what types of events	meetup|conference|networking
Jane Waite is the speaker of what types of events	conference
Nimit Jain is the speaker of what types of events	conference
Beth Niblock is the speaker of what types of events	conference
Chris Riley is the speaker of what types of events	conference|networking|expo
Alexander Klöpping is the speaker of what types of events	meetup|conference|networking|demo_day
Nick Edouard is the speaker of what types of events	conference
Greg Wojciechowski is the speaker of what types of events	conference
Slawek Kierner is the speaker of what types of events	meetup|conference|expo
Didier Coeurnelle is the speaker of what types of events	conference
Nadeem Ahmad Khan is the speaker of what types of events	conference
Brandon Chu is the speaker of what types of events	conference
William Hambrecht is the speaker of what types of events	conference
Robert London is the speaker of what types of events	conference
Eric Sutton is the speaker of what types of events	conference
Jason Finger is the speaker of what types of events	seminar|class|festival|conference|networking
Cyril Paglino is the speaker of what types of events	conference|networking
Bruce Porter Jr is the speaker of what types of events	competition|conference|networking|expo
Blake Thomas is the speaker of what types of events	conference
Peter Marber is the speaker of what types of events	conference
Menahem Yanku is the speaker of what types of events	conference
Pamela Heiligenthal is the speaker of what types of events	conference|networking
Nora Levinson is the speaker of what types of events	competition|meetup|festival|conference|networking
Ben Sturgeon is the speaker of what types of events	seminar|conference
Ankush Jain is the speaker of what types of events	seminar|conference
Pablo Slough is the speaker of what types of events	conference
Sarah Epler is the speaker of what types of events	expo|competition|class|meetup|conference|hackathon|networking
Beverly Parker is the speaker of what types of events	conference
Shaul Eliahou-Niv is the speaker of what types of events	conference
Florence Okoye is the speaker of what types of events	conference
Alina Suslova is the speaker of what types of events	conference|networking
Cahlen Humphreys is the speaker of what types of events	conference
