Pre Seed Round - Wyoming Hyperscale is led by investors from what countries	USA
Pre Seed Round - Cloudchain Technologies is led by investors from what countries	USA
Series B - AppCard is led by investors from what countries	DEU
Pre Seed Round - Odiggo is led by investors from what countries	SAU
Pre Seed Round - Insight Optics is led by investors from what countries	USA
Series C - Hopscotch is led by investors from what countries	SGP
Seed Round - Prismatic is led by investors from what countries	USA
Pre Seed Round - COR is led by investors from what countries	ARG
Post-IPO Equity - Luminex Resources is led by investors from what countries	CAN
Seed Round - HubLocal is led by investors from what countries	BRA
Seed Round - BitCV is led by investors from what countries	CHN
Series A - Seagoor is led by investors from what countries	CHN
Angel Round - Different Sign is led by investors from what countries	SAU
Convertible Note - Foody is led by investors from what countries	COL
Pre Seed Round - Sysres Technologies Private Limited is led by investors from what countries	ARE
Series A - Grupo KPG is led by investors from what countries	BRA
Grant - Lund University is led by investors from what countries	CHE
Series E - Helion Energy is led by investors from what countries	USA
Series B - Ripple Street is led by investors from what countries	USA
Series D - EverlyWell is led by investors from what countries	USA
Grant - Abington School District is led by investors from what countries	USA
Pre Seed Round - Peros Industries is led by investors from what countries	HKG
Angel Round - Neuron is led by investors from what countries	IND
Pre Seed Round - uDroppy is led by investors from what countries	USA
Seed Round - Inserviss Marketplace is led by investors from what countries	USA
Venture Round - Hire Space is led by investors from what countries	GBR
Angel Round - Caymus Technology Ventures is led by investors from what countries	USA
Equity Crowdfunding - Okappy Ltd. is led by investors from what countries	USA
Seed Round - bunq is led by investors from what countries	NLD
Seed Round - Small Pharma is led by investors from what countries	GBR
Angel Round - Scandit is led by investors from what countries	CHE
Venture Round - 77traders is led by investors from what countries	IND
Angel Round - Valiant Game Studio is led by investors from what countries	SWE
Venture Round - SAVORTEX is led by investors from what countries	GBR
Seed Round - Inventsys DESKO is led by investors from what countries	BRA
Series A - LoanTap is led by investors from what countries	IND
Inc. is led by investors from what countries	USA
Seed Round - Dessire is led by investors from what countries	ESP
Seed Round - Invitadisima is led by investors from what countries	ESP
Seed Round - mySugr is led by investors from what countries	AUT
Series A - Spacetrain is led by investors from what countries	FRA
Seed Round - Element Data is led by investors from what countries	USA
Seed Round - CrowdTunes is led by investors from what countries	USA
Debt Financing - Chaitanya is led by investors from what countries	IND
Non Equity Assistance - SCARLETRED is led by investors from what countries	AUT
Pre Seed Round - Gadgetx is led by investors from what countries	USA
Seed Round - CHSI Technologies is led by investors from what countries	USA
Series C - Schr√∂dinger is led by investors from what countries	USA
Angel Round - Yap is led by investors from what countries	USA
Seed Round - Chefmarket.ru is led by investors from what countries	RUS
Series A - Smappee is led by investors from what countries	BEL
Pre Seed Round - Replay.io is led by investors from what countries	USA
Angel Round - Athennian is led by investors from what countries	CAN
Seed Round - BJTech is led by investors from what countries	IDN
Angel Round - Gradient Cyber is led by investors from what countries	USA
Seed Round - Art and Design International is led by investors from what countries	KOR
Seed Round - Brand Brain Media is led by investors from what countries	USA
Seed Round - Bikeep is led by investors from what countries	EST
Series B - Slate Science (Matific) is led by investors from what countries	AUS
Pre Seed Round - Trustap is led by investors from what countries	USA
Pre Seed Round - Bonfire Digital Wellness is led by investors from what countries	USA
Angel Round - Matrubharti is led by investors from what countries	IND
Series A - Deserve is led by investors from what countries	USA
Seed Round - Droople is led by investors from what countries	CHE
Seed Round - Think Big Analytics is led by investors from what countries	USA
Seed Round - Augmate is led by investors from what countries	USA
Series A - MILES is led by investors from what countries	DEU
Seed Round - Nanoprecise Sci Corp is led by investors from what countries	GBR
Series C - Amwell is led by investors from what countries	USA
Pre Seed Round - HeyDesk ApS is led by investors from what countries	DNK
Pre Seed Round - Zomo.fit is led by investors from what countries	USA
Seed Round - Promoty is led by investors from what countries	EST
Venture Round - Flock is led by investors from what countries	USA
Seed Round - Yees is led by investors from what countries	ESP
Angel Round - GScan is led by investors from what countries	EST
Venture Round - Paytm Payments Bank Customer service is led by investors from what countries	IND
Seed Round - Earthbound Games is led by investors from what countries	GBR
Seed Round - Intezer is led by investors from what countries	ISR
Seed Round - SHPIGEL is led by investors from what countries	ALB
Seed Round - Emprus Space (Pty) Ltd. is led by investors from what countries	ZAF
Debt Financing - Gayo Capital is led by investors from what countries	IDN
Seed Round - Wisco Valley is led by investors from what countries	KHM
Series A - Jointer is led by investors from what countries	USA
Pre Seed Round - PartsCargo is led by investors from what countries	USA
Pre Seed Round - Flapper Technologies is led by investors from what countries	USA
Series B - evocatal is led by investors from what countries	DEU
Seed Round - Cafe Brunch is led by investors from what countries	IND
Series C - HemoShear Therapeutics is led by investors from what countries	USA
Angel Round - CakeBoss is led by investors from what countries	CHN
Seed Round - Roomonitor is led by investors from what countries	ESP
Seed Round - Zotalabs is led by investors from what countries	IND
Series A - Chefmarket.ru is led by investors from what countries	RUS
Angel Round - Ali Rasoul LTD is led by investors from what countries	GBR
Corporate Round - GoBeyond is led by investors from what countries	ARE
Angel Round - LineMetrics is led by investors from what countries	AUT
Venture Round - Workgroups DaVinci is led by investors from what countries	USA
Series B - Brillouin Energy is led by investors from what countries	USA
Seed Round - My Fans is led by investors from what countries	IDN
Series B - Chockstone is led by investors from what countries	USA
Angel Round - Doubtnut is led by investors from what countries	IND
