the exhibitor of NAB Show 2018 are from what industries	Content_Discovery|Android|Information_Technology|Electronics|Broadcasting|Compliance|CRM|Enterprise_Software|Mobile_Apps|Software|Communication_Hardware|Subscription_Service|Insurance|Cloud_Infrastructure|Information_Services|Gaming|3D_Technology|Real_Time|Audio|Manufacturing|TV|Cloud_Management|iOS|Knowledge_Management|Wireless|Data_Center|News|Computer|Intellectual_Property|Predictive_Analytics|Video_Chat|Robotics|Collaboration|Artificial_Intelligence|Video_Streaming|Content|Cloud_Security|Cloud_Computing|Apps|Virtual_Reality|Cloud_Data_Services|Quality_Assurance|PaaS|Public_Relations|Video|Data_Storage|Price_Comparison|Sports|Computer_Vision|Digital_Entertainment|Delivery|Social_Network|Billing|Data_Visualization|Social_Media|Augmented_Reality|Big_Data|Point_of_Sale|Video_on_Demand|Film|Publishing|Consumer_Electronics|Hospitality|Payments|Machine_Learning|Animation|Web_Hosting|Media_and_Entertainment|Music|Service_Industry|Mobile|Enterprise|Analytics|TV_Production|Network_Security|Communications_Infrastructure|Public_Safety|File_Sharing|Advertising|E-Commerce|Internet|Photography|Semantic_Web|Digital_Media|Content_Delivery_Network|Infrastructure|Video_Editing|Hardware|SaaS|Telecommunications|National_Security|Cloud_Storage|Product_Design
the exhibitor of MuleSoft Connect 2018 are from what industries	CRM|Analytics|Software|Computer|Consulting
the exhibitor of AI World Conference and Expo 2019 are from what industries	Web_Development|Energy_Efficiency|Information_Technology|Electronics|Security|Professional_Services|Data_Visualization|Asset_Management|E-Commerce|Internet|Supply_Chain_Management|Predictive_Analytics|Big_Data|Information_and_Communications_Technology_(ICT)|Consulting|CRM|Life_Science|Enterprise_Software|Software|Text_Analytics|Customer_Service|Computer|Image_Recognition|Robotics|Fashion|Health_Diagnostics|Natural_Language_Processing|Artificial_Intelligence|Small_and_Medium_Businesses|Management_Consulting|Recruiting|Field_Support|Machine_Learning|Cloud_Computing|Information_Services|Cloud_Data_Services|PaaS|Hardware|Risk_Management|Health_Care|Home_Decor|Real_Time|SaaS|Service_Industry|IT_Infrastructure|Crowdsourcing|Medical|Enterprise_Applications|Video|Manufacturing|Communities|Business_Intelligence|Cyber_Security|Career_Planning|Human_Resources|National_Security|Data_Integration|Medical_Device|Analytics|Computer_Vision|Staffing_Agency|Product_Design|Education|Furniture|Social_Network|Network_Security|Communications_Infrastructure|Retail|Speech_Recognition|InsurTech
the exhibitor of NYC TechBreakfast are from what industries	Marketplace|Marketing_Automation|Software|Commercial_Real_Estate|Event_Management|Real_Estate|Rental|SaaS|Property_Management|Restaurants|Rental_Property|Events
the exhibitor of Customer Service Summit West 2019 are from what industries	Enterprise_Software|Sales|Corporate_Training|Software|Customer_Service|Analytics|Advertising|VoIP|Marketing
the exhibitor of Midem 2017 are from what industries	Lead_Generation|Social|Music|Content_Delivery_Network|Music_Venues|Artificial_Intelligence|Media_and_Entertainment|Social_Network|Nightlife|Video|Apps|Big_Data|Machine_Learning
the exhibitor of AR & VR World 2018 are from what industries	Android|Web_Browsers|Ediscovery|Information_Technology|Electronics|Broadcasting|Advertising|Data_Visualization|E-Commerce|Internet|Augmented_Reality|Enterprise_Software|Software|Digital_Media|Consumer_Electronics|Image_Recognition|Robotics|Artificial_Intelligence|Industrial|Video_Streaming|Machine_Learning|Marketing|Apps|Virtual_Reality|Retail_Technology|Information_Services|Cloud_Computing|Visual_Search|Personalization|B2B|Hardware|3D_Technology|Real_Time|SaaS|Document_Management|Service_Industry|Web_Hosting|Enterprise_Applications|Wearables|Telecommunications|Communities|Social_Media_Advertising|Mobile|Enterprise|IT_Management|Cloud_Storage|Eyewear|Google_Glass|Data_Center|Product_Design|Market_Research|Printing|Internet_of_Things
the exhibitor of Commercial UAV EXPO Americas 2018 are from what industries	Information_Technology|Electronics|GPS|Sensor|CRM|Events|Universities|Enterprise_Software|CAD|Mobile_Apps|Software|Smart_Building|Insurance|Marketing|Smart_Cities|Information_Services|Gaming|CivicTech|3D_Technology|EdTech|Manufacturing|Software_Engineering|Wireless|Autonomous_Vehicles|Finance|STEM_Education|Network_Hardware|Computer|Security|Semiconductor|Mapping_Services|Continuing_Education|Recycling|Battery|Image_Recognition|Robotics|Commercial|Artificial_Intelligence|Video_Streaming|Drones|Solar|Public_Relations|Higher_Education|Training|Video|Music_Education|Test_and_Measurement|Computer_Vision|Digital_Entertainment|Agriculture|Air_Transportation|Education|Automotive|Data_Visualization|Data_Mining|Government|Social_Media|Drone_Management|Big_Data|Consumer_Electronics|Innovation_Management|Machine_Learning|Laser|Construction|Web_Hosting|Consumer|Service_Industry|Indoor_Positioning|Mobile|Enterprise|Energy|Mechanical_Engineering|Analytics|Geospatial|Navigation|Photo_Editing|Aerospace|Farming|Industrial_Automation|Industrial_Engineering|Event_Management|Advertising|Venture_Capital|Photography|Internet|Web_Design|Consulting|Financial_Services|Legal|AgTech|Social_Impact|Infrastructure|Hardware|SaaS|Telecommunications|Location_Based_Services|Cyber_Security|National_Security|Electric_Vehicle|Motion_Capture|Product_Design|Market_Research|Internet_of_Things
the exhibitor of Deep Learning in Healthcare Summit, Boston are from what industries	Life_Science|Analytics|Health_Care|Software|Biotechnology|Health_Diagnostics|Medical|Artificial_Intelligence|Machine_Learning
the exhibitor of AHR Expo 2019 are from what industries	Energy_Efficiency|Consumer_Electronics|Smart_Building|Smart_Home|Internet_of_Things
the exhibitor of Make in LA Class 3 Hardware Demo Day are from what industries	Laser|Energy|Construction|Solar|Sensor|CleanTech
the exhibitor of Dublin Tech Summit are from what industries	SMS|Email_Marketing|Marketing_Automation|Advertising|Brand_Marketing|Enterprise_Software|Mobile_Apps|Software|Digital_Media|Lifestyle|Content_Marketing|Video_Editing|Business_Information_Systems|Real_Time|SaaS|Video|Transaction_Processing|Social_Media_Marketing|Mobile_Advertising|Market_Research|TV_Production|Digital_Signage|Video_Advertising
the exhibitor of BootstrapLabs Applied Artificial Intelligence Conference 2018 are from what industries	Cyber_Security|Enterprise_Software|Cloud_Data_Services|National_Security|Software|Data_Visualization|Blockchain|IT_Infrastructure|Internet_of_Things
the exhibitor of Cable Congress are from what industries	Information_Technology|Software|Broadcasting|Construction|TV_Production|Outsourcing|Video_Streaming|Business_Development|Marketing|Telecommunications|Manufacturing|Education|Consulting|Film_Distribution
the exhibitor of How to Captivate Any Audience in Less Than 30 Seconds are from what industries	Food_Processing|Mobile_Apps|Video_Conferencing|Customer_Service|Internet|Private_Social_Networking|Social_Media|Video|Apps|Education
the exhibitor of 1 Million Cups Irvine - Startup and Investor Panel are from what industries	Human_Resources|Employment
the exhibitor of Bay Angels - Investor Pitch Event -Feb 26, 2019 are from what industries	Home_Health_Care|Information_Technology|Analytics|Health_Care|Consumer_Electronics|Software|Messaging|Internet|Wearables|Sporting_Goods|Golf
the exhibitor of International Association of Campus Law Enforcement Administrators (IACLEA) are from what industries	Social_Media|Computer
the exhibitor of Meet Alessandra Sollberger, VC at Mosaic Ventures are from what industries	Manufacturing
the exhibitor of Gartner CIOxchange Italy 2017 are from what industries	Web_Development|Enterprise_Software|Information_Technology|IT_Management|Analytics|Software|Wireless|Data_Visualization|Data_Center|Network_Security|Big_Data|Business_Intelligence
the exhibitor of Newark Venture Partners Fall 2017 Demo Day are from what industries	Information_Technology|Sales|E-Commerce|Call_Center|Fitness|CRM|Organic|Enterprise_Software|Meeting_Software|Software|Customer_Service|Collaboration|Fashion|Artificial_Intelligence|Marketing|Machine_Learning|Health_Care|Employment|Service_Industry|Property_Management|Sales_Automation|Mobile|Medical_Device|Real_Estate|Waste_Management
the exhibitor of CIPR-2018 are from what industries	Enterprise_Software|Industrial_Automation|Risk_Management|Asset_Management|Robotics|Industrial|Machine_Learning|Predictive_Analytics
the exhibitor of Mackinac Policy Conference are from what industries	Sports|Health_Care|Personal_Health|Wellness|Fitness|Nutrition
the exhibitor of Laser World of Photonics 2019 are from what industries	Laser|Industrial_Automation|Industrial_Engineering|Medical_Device|Semiconductor|Autonomous_Vehicles|Machinery_Manufacturing
the exhibitor of Blockchain Expo North America 2018 are from what industries	Information_Technology|B2C|CRM|Events|Enterprise_Software|Mobile_Apps|Sustainability|Software|Impact_Investing|Marketing|Cloud_Infrastructure|Database|Information_Services|Gaming|Ad_Network|Real_Time|Peer_to_Peer|Property_Management|Manufacturing|Software_Engineering|Travel|Technical_Support|iOS|Human_Resources|Consumer_Goods|Knowledge_Management|Real_Estate|Financial_Exchanges|Autonomous_Vehicles|Finance|Trading_Platform|Staffing_Agency|Retail|Computer|Social_Entrepreneurship|Security|Rental|Developer_Platform|Predictive_Analytics|Shopping|Robotics|Artificial_Intelligence|Industrial|Facilities_Support_Services|Cryptocurrency|Cloud_Computing|Apps|Virtual_Reality|Open_Source|Marketplace|Lending|PaaS|Public_Relations|Fuel|Enterprise_Applications|Crowdfunding|Video|Business_Intelligence|IT_Management|Renewable_Energy|Digital_Entertainment|Agriculture|Social_Network|Energy_Efficiency|FinTech|Asset_Management|Social_Media|Supply_Chain_Management|Big_Data|Point_of_Sale|Customer_Service|Hospitality|Bitcoin|Payments|Privacy|Field_Support|Machine_Learning|Residential|Online_Portals|B2B|Banking|Business_Information_Systems|Construction|Media_and_Entertainment|Service_Industry|Mobile|Data_Integration|Energy|Analytics|Coffee|Blockchain|Non_Profit|Ethereum|Identity_Management|Crowdsourcing|Event_Management|Affiliate_Marketing|Advertising|Oil_and_Gas|E-Commerce|Internet|Consulting|Financial_Services|Consumer_Lending|Mobile_Payments|Legal|Social_Impact|Infrastructure|Accounting|Business_Development|Search_Engine|Consumer_Reviews|Hardware|Loyalty_Programs|SaaS|Building_Maintenance|Telecommunications|Cyber_Security|Internet_of_Things
the exhibitor of DemoPalooza 2017 are from what industries	Retail_Technology|Marketing|Identity_Management|Big_Data|Internet_of_Things
the exhibitor of Superinvestor 2017 are from what industries	Enterprise_Software|Financial_Services|Analytics|Market_Research|Finance
the exhibitor of Applied AI Summit Houston 2018 are from what industries	Enterprise_Software|Photo_Editing|Information_Technology|Facial_Recognition|Software|Image_Recognition|Robotics|SaaS|Artificial_Intelligence|Small_and_Medium_Businesses|Machine_Learning|Cloud_Computing|Predictive_Analytics|Computer
the exhibitor of Ai4 Healthcare 2019 are from what industries	Android|Information_Technology|Security|Event_Management|Scheduling|Supply_Chain_Management|Home_Health_Care|Enterprise_Software|Software|Personal_Health|Robotics|Natural_Language_Processing|Artificial_Intelligence|Human_Computer_Interaction|Machine_Learning|Cloud_Security|Productivity_Tools|Digital_Marketing|Health_Care|Social|SaaS|Outpatient_Care|Hospital|Medical|Communities|Cyber_Security|Mobile|iOS|Medical_Device|Analytics|mHealth|Eyewear|Network_Security|Computer
the exhibitor of Mobility Row 2020 are from what industries	Last_Mile_Transportation|Software|Robotics|SaaS|Artificial_Intelligence|Machine_Learning|Logistics|Smart_Cities
the exhibitor of LvivCSS are from what industries	Enterprise_Software|Mobile_Apps|Video_Conferencing|Software|Collaboration|SaaS|Messaging|Cloud_Security|Communities|Video_Chat
the exhibitor of Best Practices for Automotive 2015 are from what industries	Web_Development|Information_Technology|Professional_Services|E-Commerce|Internet|Advice|Consulting|CRM|Enterprise_Software|Mobile_Apps|Software|Consumer_Electronics|Infrastructure|Management_Consulting|Business_Development|Information_Services|Cloud_Computing|Business_Information_Systems|Hardware|Service_Industry|Manufacturing|Cyber_Security|IT_Management|Computer
the exhibitor of O'Reilly TensorFlow World 2019 are from what industries	Developer_APIs|Open_Source|Analytics|Artificial_Intelligence|Machine_Learning|Big_Data
the exhibitor of STEP USA: A German Startup Pitch Night with GACCNY are from what industries	Information_Technology|Automotive|Analytics|Software|Consumer_Electronics|Text_Analytics|3D_Technology|Legal|Robotics|Intellectual_Property|Sensor|Venture_Capital|Autonomous_Vehicles|Artificial_Intelligence|SaaS|Machine_Learning|Big_Data
the exhibitor of SaaStr Europa are from what industries	Personalization|Information_Technology|Enterprise|Human_Resources|Analytics|Marketing_Automation|Text_Analytics|E-Commerce|SaaS|Artificial_Intelligence
the exhibitor of 3686 Southern Series - Arlington, VA are from what industries	Security|Wellness|FinTech|Data_Visualization|E-Commerce|Government|Developer_Platform|Politics|CRM|Mobile_Apps|Local_Business|Software|Fashion|Small_and_Medium_Businesses|Privacy|Developer_Tools|Cloud_Security|Internet_of_Things|Cloud_Computing|Apps|Developer_APIs|Health_Care|SaaS|Food_and_Beverage|Restaurants|Cloud_Management|Cyber_Security|Mobile|mHealth|Network_Security|Identity_Management|Education|Gift_Card
the exhibitor of IEC 61850 Global are from what industries	Power_Grid|Energy
the exhibitor of Techstars Boston Fall 2014 Demo Day are from what industries	Web_Development|Energy_Efficiency|Electronics|File_Sharing|Wellness|Affiliate_Marketing|Fitness|Social_Media|Brand_Marketing|Enterprise_Software|Software|Digital_Media|Consumer_Electronics|Content_Delivery_Network|Artificial_Intelligence|Developer_Tools|Video_Streaming|Machine_Learning|Virtual_Reality|Developer_APIs|Cloud_Data_Services|Open_Source|Hardware|Health_Care|Outdoors|SaaS|Music|Audio|IT_Infrastructure|Telecommunications|Sporting_Goods|Wearables|Manufacturing|Video|Content_Creators|Travel|Mobile|Social_Media_Marketing|Sports|PC_Games|Wireless|Data_Center|Product_Design|Delivery|Information_and_Communications_Technology_(ICT)|Education|Computer
the exhibitor of Startup Week Vancouver are from what industries	Web_Development|Technical_Support|Analytics|Software|Customer_Service|Product_Research|A/B_Testing|Usability_Testing|Product_Management|Productivity_Tools
the exhibitor of Percona Live Data Performance Conference 2016 are from what industries	Information_Technology|File_Sharing|E-Commerce|Internet|Data_Center_Automation|Operating_Systems|Predictive_Analytics|Big_Data|Management_Information_Systems|CRM|Consulting|Universities|Enterprise_Software|Software|Flash_Storage|Innovation_Management|Database|E-Learning|Linux|Cloud_Computing|Open_Source|Hardware|Web_Hosting|IT_Infrastructure|Business_Intelligence|Cloud_Management|Knowledge_Management|Analytics|Project_Management|Education
the exhibitor of TECOM Conference are from what industries	Venture_Capital|Information_Technology|Consulting
the exhibitor of Fintegrate Zone 2019 are from what industries	Banking|FinTech|Blockchain|Internet|Cryptocurrency
the exhibitor of FAMEX 2021 are from what industries	Virtual_Reality|Information_Technology|Aerospace|Augmented_Reality
the exhibitor of Connect Chicago Fall 2019 are from what industries	Energy_Efficiency|Risk_Management|Construction
the exhibitor of The Forward Festival are from what industries	Sports|Personal_Health|Fashion|Fitness|Wearables|Predictive_Analytics|Internet_of_Things
the exhibitor of SC15 are from what industries	Content_Discovery|Information_Technology|Electronics|Sensor|Private_Social_Networking|Management_Information_Systems|CRM|Advice|Universities|Enterprise_Software|Mobile_Apps|Sustainability|Software|Communication_Hardware|Developer_Tools|Marketing|Cloud_Infrastructure|Database|Insurance|Information_Services|Linux|Charter_Schools|EdTech|IT_Infrastructure|Medical|Manufacturing|Cloud_Management|Travel|Chemical|Consumer_Goods|Technical_Support|iOS|Knowledge_Management|Embedded_Software|Wireless|Data_Center|News|Finance|Lighting|Information_and_Communications_Technology_(ICT)|GPU|Network_Hardware|Computer|Staffing_Agency|Security|Semiconductor|Virtualization|Developer_Platform|Politics|Predictive_Analytics|Collaboration|Robotics|Artificial_Intelligence|Industrial|Content|Cloud_Security|Cloud_Computing|Virtual_Reality|Open_Source|Cloud_Data_Services|Green_Building|Marketplace|Application_Performance_Management|Space_Travel|Industrial_Manufacturing|Product_Research|Travel_Agency|Public_Relations|Electronic_Design_Automation_(EDA)|Higher_Education|Training|Video|Business_Intelligence|Career_Planning|Field-Programmable_Gate_Array_(FPGA)|Data_Storage|IT_Management|Computer_Vision|Delivery|Agriculture|Social_Network|Education|Energy_Efficiency|Automotive|Asset_Management|Data_Mining|Government|Operating_Systems|Civil_Engineering|Big_Data|Life_Science|Publishing|Consumer_Electronics|Energy_Management|Health_Diagnostics|Privacy|Innovation_Management|Flash_Storage|Machine_Learning|Banking|Business_Information_Systems|Construction|Web_Hosting|Service_Industry|Satellite_Communication|Home_Renovation|Mobile|Enterprise|Energy|Mechanical_Engineering|Analytics|Local|Video_Games|Association|Non_Profit|Embedded_Systems|Communications_Infrastructure|Network_Security|Identity_Management|Industrial_Automation|Aerospace|Professional_Services|Industrial_Engineering|Chemical_Engineering|Data_Center_Automation|Internet|Mobile_Devices|Consulting|Electrical_Distribution|Financial_Services|Legal|AgTech|Infrastructure|Business_Development|Logistics|E-Learning|Search_Engine|Digital_Marketing|Hardware|Health_Care|SaaS|Biotechnology|Food_and_Beverage|Telecommunications|Communities|Cyber_Security|National_Security|Cloud_Storage|Optical_Communication|Nanotechnology|Quantum_Computing|Product_Design|Market_Research|Internet_of_Things
the exhibitor of Retail Connect are from what industries	Digital_Marketing|E-Commerce|Internet|Brand_Marketing|Marketing|Retail_Technology|Consulting
the exhibitor of Plug & Play Winter Summit are from what industries	Last_Mile_Transportation|Software|Robotics|SaaS|Artificial_Intelligence|Machine_Learning|Logistics|Smart_Cities
the exhibitor of ASRM 2017 are from what industries	Home_Health_Care|Medical_Device|Health_Care|mHealth|Biotechnology|Health_Diagnostics|Medical|Machine_Learning
the exhibitor of Archilyse are from what industries	Property_Development|Analytics|Real_Estate|SaaS|Predictive_Analytics|Big_Data|Consulting
the exhibitor of Startup Village 2017 are from what industries	Mobile|Financial_Services|FinTech|Affiliate_Marketing|Advertising|Finance|Trading_Platform|Advertising_Platforms|Billing|Local_Advertising
the exhibitor of ICOI Winter Implant Symposium are from what industries	Software|Health_Care|Information_Technology|SaaS
the exhibitor of The Commercial UAV Show UK 2018 are from what industries	Electronics|Software|Drones|Drone_Management|Embedded_Systems
the exhibitor of AEC Next Technology Expo + Conference and SPAR 3D Expo & Conference are from what industries	Information_Technology|Industrial_Engineering|Project_Management|Commercial_Real_Estate|Software|Smart_Building|Construction|3D_Technology|SaaS|Augmented_Reality
the exhibitor of Cell Line Development & Engineering 2017 are from what industries	Information_Technology|Industrial_Engineering|Oil_and_Gas|Internet|Food_Processing|Life_Science|Software|Image_Recognition|Robotics|Health_Diagnostics|Biopharma|Product_Search|Therapeutics|Plastics_and_Rubber_Manufacturing|Health_Care|Hardware|Product_Research|Biotechnology|Service_Industry|Medical|Food_and_Beverage|Manufacturing|Chemical|Medical_Device|Agriculture|Pharmaceutical
the exhibitor of Last Mile Fulfilment Asia 2016 are from what industries	Information_Technology|Electronics|E-Commerce|Internet|B2C|Supply_Chain_Management|Enterprise_Software|Software|Freight_Service|Logistics|Apps|B2B|Real_Time|SaaS|VoIP|Mobile|Courier_Service|Delivery|Transportation
the exhibitor of SYNERGY GLOBAL FORUM NEW YORK are from what industries	Digital_Marketing|Public_Safety|Media_and_Entertainment|Public_Relations|Artificial_Intelligence|Brand_Marketing
the exhibitor of 5G Asia 2019 are from what industries	Software|Software_Engineering|Information_Technology
the exhibitor of The Future of Swedish & Danish Life Science 2017 are from what industries	Information_Technology|Water_Purification|Dietary_Supplements|Government|Photography|CRM|Consulting|Life_Science|Environmental_Consulting|Software|Legal|Recruiting|Cloud_Data_Services|Hardware|Health_Care|Biotechnology|SaaS|Medical|Manufacturing|Energy|Nanotechnology|Pharmaceutical|Education
the exhibitor of Bay Angels Investors Event 2019 are from what industries	DRM|Security|Public_Safety|FinTech|Gamification|Online_Games|GovTech|Big_Data|Software|Artificial_Intelligence|Machine_Learning|Cloud_Security|Smart_Cities|Information_Services|Gaming|SaaS|Wearables|Manufacturing|Cyber_Security|PC_Games|Computer_Vision|Video_Games|Blockchain|Geospatial|Identity_Management|Education
the exhibitor of Demo Day for Class VI of the Alchemist Accelerator are from what industries	Web_Development|Information_Technology|Security|Sales|Marketing_Automation|Advertising|Internet|Big_Data|Advertising_Platforms|CRM|Events|Enterprise_Software|CAD|Software|Wired_Telecommunications|Robotics|Industrial|Field_Support|Logistics|3D_Printing|Drones|SaaS|Emerging_Markets|Telecommunications|Manufacturing|Sales_Automation|Mobile|Social_Media_Marketing|Mechanical_Engineering|Mobile_Advertising|Computer|Internet_of_Things
the exhibitor of Mobile Next are from what industries	Mobile|Analytics|Marketing_Automation|Real_Time|SaaS
the exhibitor of Gartner IT Infrastructure & Data Center Summit Tokyo 2017 are from what industries	Web_Development|Information_Technology|Electronics|E-Commerce|Venture_Capital|Virtualization|Internet|Developer_Platform|Operating_Systems|Predictive_Analytics|Big_Data|Enterprise_Software|Software|Artificial_Intelligence|Infrastructure|Flash_Storage|Cloud_Infrastructure|Information_Services|Cloud_Computing|Virtual_Reality|Linux|Cloud_Data_Services|Open_Source|Banking|Hardware|Web_Hosting|IT_Infrastructure|Telecommunications|Business_Intelligence|Cloud_Management|Mobile|Communications_Infrastructure|Data_Storage|IT_Management|Analytics|Wireless|Data_Center|Network_Security|Information_and_Communications_Technology_(ICT)|GPU|Intelligent_Systems
the exhibitor of Entrepreneur Expo are from what industries	Search_Engine|Lending|Financial_Services|Events|Analytics|Software|Marketing_Automation|Event_Management|Intellectual_Property|FinTech|SaaS|Small_and_Medium_Businesses|Internet|Business_Intelligence
the exhibitor of Tech Open Air 2019 are from what industries	Information_Technology|Automotive|Computer_Vision|Natural_Language_Processing|Artificial_Intelligence|Machine_Learning|Internet_of_Things
the exhibitor of Bett Show 2016 are from what industries	Power_Grid|Android|Information_Technology|Electronics|Corporate_Training|DSP|Online_Games|Compliance|Management_Information_Systems|CRM|Clean_Energy|Universities|Enterprise_Software|Events|Mobile_Apps|Software|Impact_Investing|Smart_Building|Lifestyle|Communication_Hardware|Personal_Development|Developer_Tools|Marketing|Cloud_Infrastructure|Smart_Cities|Linux|Information_Services|Gaming|CivicTech|3D_Printing|Charter_Schools|3D_Technology|EdTech|Audio|IT_Infrastructure|Wearables|UX_Design|Primary_Education|Film_Production|Manufacturing|TV|Software_Engineering|Local_Advertising|Cloud_Management|Travel|iOS|Edutainment|Consumer_Goods|Chemical|Human_Resources|Project_Management|Knowledge_Management|Wireless|Data_Center|DIY|News|Energy_Storage|Finance|STEM_Education|Lighting|Information_and_Communications_Technology_(ICT)|Retail|Computer|Graphic_Design|Security|Unified_Communications|Mapping_Services|Virtualization|Messaging|Women's|Children|Predictive_Analytics|Advertising_Platforms|Shopping|Secondary_Education|Collaboration|Robotics|Toys|Tutoring|Artificial_Intelligence|Industrial|Commercial|Video_Streaming|Content|Cloud_Security|Skill_Assessment|Cloud_Computing|Apps|Virtual_Reality|Open_Source|Cloud_Data_Services|App_Discovery|Drones|Industrial_Manufacturing|Public_Relations|Higher_Education|VoIP|NFC|Training|Video|Business_Intelligence|Music_Education|Data_Storage|IT_Management|Price_Comparison|Medical_Device|Test_and_Measurement|Digital_Entertainment|Delivery|Digital_Signage|Social_Network|Education|Web_Development|macOS|Energy_Efficiency|Data_Visualization|Asset_Management|Government|Social_Media|Augmented_Reality|Operating_Systems|Supply_Chain_Management|Big_Data|Point_of_Sale|Video_on_Demand|Assistive_Technology|Publishing|Film|Consumer_Electronics|Customer_Service|Energy_Management|Recruiting|Health_Diagnostics|Small_and_Medium_Businesses|Flash_Storage|Machine_Learning|Retail_Technology|Productivity_Tools|Developer_APIs|Online_Portals|Personalization|B2B|Business_Information_Systems|Web_Hosting|Consumer|Media_and_Entertainment|Service_Industry|Animation|Music|Presentations|Mobile|Enterprise|Fraud_Detection|Energy|Mechanical_Engineering|Analytics|Food_Delivery|Local|Language_Learning|Video_Games|Mobile_Advertising|Association|Non_Profit|Transportation|Network_Security|Identity_Management|Communications_Infrastructure|Intelligent_Systems|Crowdsourcing|Industrial_Automation|Industrial_Engineering|Professional_Services|Public_Safety|Wellness|Advertising|E-Commerce|Venture_Capital|Internet|Photography|Web_Design|Mobile_Devices|GovTech|Consulting|Electrical_Distribution|Financial_Services|Handmade|Digital_Media|Social_Impact|Infrastructure|Business_Development|Smart_Home|E-Learning|Search_Engine|EBooks|Hardware|Health_Care|SaaS|Biotechnology|Telecommunications|Leisure|Communities|Social_Media_Advertising|Consumer_Research|Cyber_Security|National_Security|Product_Design|Market_Research|Printing|Internet_of_Things
the exhibitor of Event Horizon 2019 are from what industries	Information_Technology|Data_Integration|Financial_Services|Marketplace|FinTech|Personal_Finance|Consumer
the exhibitor of Techsauce Global Summit are from what industries	Information_Technology|Financial_Services|Analytics|Software|Health_Care|Health_Insurance|FinTech|Personal_Finance|Biotechnology|Health_Diagnostics|Insurance|InsurTech|Big_Data|Internet_of_Things
the exhibitor of Startupbootcamp FinTech London Demo Day 2014 are from what industries	Information_Technology|FinTech|Internet|Financial_Services|Software|Payments|Innovation_Management|Accounting|Insurance|Online_Portals|B2B|Marketplace|Banking|SaaS|Crowdfunding|Mobile|Analytics|Blockchain|Crowdsourcing|Internet_of_Things
the exhibitor of Industry of Things World USA 2017 are from what industries	Information_Technology|Electronics|Industrial_Automation|Security|Automotive|Mining|Public_Safety|Asset_Management|Oil_and_Gas|Sensor|Internet|Operating_Systems|Mobile_Devices|Predictive_Analytics|Big_Data|Consulting|Events|Enterprise_Software|Software|Consumer_Electronics|Smart_Building|Industrial|Artificial_Intelligence|Outsourcing|Developer_Tools|Innovation_Management|Machine_Learning|Infrastructure|Smart_Cities|Information_Services|Apps|Hardware|Construction|SaaS|Service_Industry|Telecommunications|Manufacturing|Mobile|Enterprise|IT_Management|Energy|Project_Management|Wireless|Data_Center|Non_Profit|Transportation|Network_Security|Identity_Management|Computer|Internet_of_Things
the exhibitor of XLIVE Annual Conference & Expo 2018 are from what industries	SMS|Information_Technology|Photo_Editing|Nightclubs|Marketing_Automation|Event_Management|Advertising|FinTech|E-Commerce|Messaging|Internet|Photography|Ticketing|Art|Social_Media|RFID|Predictive_Analytics|Big_Data|Events|CRM|Enterprise_Software|Mobile_Apps|Publishing|Digital_Media|Software|Mobile_Payments|Hospitality|Customer_Service|Natural_Language_Processing|Artificial_Intelligence|Developer_Tools|Business_Development|Marketing|Machine_Learning|Internet_of_Things|Apps|Cloud_Computing|Productivity_Tools|Developer_APIs|Marketplace|Digital_Marketing|Health_Care|SaaS|Media_and_Entertainment|Medical|Nightlife|Restaurants|Manufacturing|Transaction_Processing|Sales_Automation|Mobile|Social_Media_Marketing|Medical_Device|Sports|Analytics|News|Printing|Association|Computer|Gift_Card
the exhibitor of Reboot Develop 2018 are from what industries	Quality_Assurance|Video_Games|Audio|Translation_Service|Marketing
the exhibitor of The AI Summit Silicon Valley 2021 are from what industries	Information_Technology|Software|Artificial_Intelligence|Machine_Learning|Speech_Recognition
the exhibitor of ILTACON 2018 are from what industries	Android|Information_Technology|Electronics|Fitness|Compliance|CRM|Business_Travel|Enterprise_Software|Mobile_Apps|Software|Text_Analytics|Insurance|Cloud_Infrastructure|Database|Marketing|Information_Services|Social_News|Document_Management|IT_Infrastructure|Medical|Manufacturing|Software_Engineering|Cloud_Management|iOS|Human_Resources|Project_Management|Knowledge_Management|Wireless|News|Clinical_Trials|Finance|Pharmaceutical|Retail|Computer|Web_Browsers|Security|Unified_Communications|Semiconductor|Virtualization|Messaging|Scheduling|Predictive_Analytics|Meeting_Software|Image_Recognition|Collaboration|Robotics|Artificial_Intelligence|Content|Cloud_Security|Legal_Tech|Cloud_Computing|Apps|Cryptocurrency|Cloud_Data_Services|Quality_Assurance|Homeland_Security|Risk_Management|Law_Enforcement|Enterprise_Applications|VoIP|Training|Video|Business_Intelligence|IT_Management|Delivery|Education|Billing|Web_Development|Video_Conferencing|FinTech|Data_Visualization|Big_Data|Publishing|Consumer_Electronics|Customer_Service|Penetration_Testing|Privacy|Flash_Storage|Machine_Learning|Retail_Technology|B2B|Web_Hosting|Service_Industry|Prediction_Markets|Mobile|Enterprise|Data_Integration|Analytics|Wholesale|Blockchain|E-Signature|Network_Security|Embedded_Systems|Identity_Management|Ediscovery|Professional_Services|File_Sharing|E-Commerce|Venture_Capital|Internet|Email|Data_Center_Automation|Web_Apps|Semantic_Search|Mobile_Devices|Consulting|Financial_Services|Digital_Media|Legal|Natural_Language_Processing|Infrastructure|Virtual_Desktop|Business_Development|Accounting|E-Learning|IaaS|Search_Engine|Digital_Marketing|Hardware|Health_Care|SaaS|Telecommunications|Consumer_Research|Cyber_Security|Document_Preparation|Printing
the exhibitor of Web Summit 2014 are from what industries	Information_Technology|Automotive|Security|FinTech|Physical_Security|Messaging|Internet|Email|Social_Media|Gamification|Augmented_Reality|Developer_Platform|B2C|Big_Data|Compliance|CRM|Food_Processing|Enterprise_Software|Financial_Services|Software|Collaboration|Natural_Language_Processing|Artificial_Intelligence|CMS|Video_Streaming|Business_Development|Machine_Learning|Virtual_Reality|Search_Engine|Personalization|B2B|Business_Information_Systems|3D_Technology|SaaS|Media_and_Entertainment|Food_and_Beverage|Manufacturing|Video|Cyber_Security|Mobile|Fraud_Detection|Local|Analytics|Video_Games|Product_Design|Social_Network|Identity_Management
the exhibitor of ICE VOX London 2020 are from what industries	Transaction_Processing|Payments|Financial_Services|Banking
the exhibitor of TechCrunch Disrupt SF 2010 are from what industries	Mobile|Mobile_Payments|Music|E-Learning|Education
the exhibitor of GSMA Mobile 360 Middle East are from what industries	Analytics|Service_Industry|Predictive_Analytics
the exhibitor of Sibos Toronto 2017 are from what industries	Web_Development|Information_Technology|FinTech|Asset_Management|Virtualization|Venture_Capital|Internet|Developer_Platform|Enterprise_Software|Financial_Services|Software|Payments|Developer_Tools|Insurance|Information_Services|Cryptocurrency|Banking|PaaS|SaaS|Blockchain|Wealth_Management|Finance|Retail
the exhibitor of Benzinga Global Fintech Awards are from what industries	Information_Technology|FinTech|Advertising|Data_Mining|Venture_Capital|Internet|Social_Media|Developer_Platform|Predictive_Analytics|Big_Data|Consulting|Enterprise_Software|Financial_Services|Software|Impact_Investing|Auto_Insurance|Natural_Language_Processing|Artificial_Intelligence|Payments|Insurance|Machine_Learning|Information_Services|Cloud_Data_Services|Marketplace|Banking|Risk_Management|Real_Time|SaaS|Property_Insurance|Business_Intelligence|Mobile|Data_Integration|IT_Management|Analytics|News|Financial_Exchanges|Wealth_Management|Finance|Social_Network|InsurTech|Education|Computer
the exhibitor of Rise of AI conference 2018 are from what industries	Reservations|Data_Integration|Hospitality|SaaS|Artificial_Intelligence|Food_and_Beverage|Ticketing|Hotel|Machine_Learning|CRM
the exhibitor of SuperReturn Middle East are from what industries	Enterprise_Software|Financial_Services|Banking|Software|Analytics|FinTech|Market_Research|Finance|Real_Estate_Investment|Insurance|Information_Services
the exhibitor of Pioneers Festival 2016 are from what industries	Cloud_Management|Software|Biotechnology|SaaS|Medical|Artificial_Intelligence|Bioinformatics
the exhibitor of DEMO CHINA Silicon Valley Summit 2016: Cross-Border Investment & Overseas Entrepreneurship are from what industries	Advanced_Materials|Textiles|Fashion
the exhibitor of Plumber TV Sketchy Sketches 1 Daniel Envy are from what industries	Digital_Entertainment|TV_Production|Comics|Animation
the exhibitor of Streaming Media West are from what industries	Enterprise_Software|Video_on_Demand|Software|Content_Delivery_Network|IT_Infrastructure|Video_Advertising|Video_Streaming|Cloud_Infrastructure|Video
the exhibitor of Techweek: Miami 2017 are from what industries	Digital_Marketing|Public_Safety|Media_and_Entertainment|Public_Relations|Artificial_Intelligence|Brand_Marketing
the exhibitor of The Future of E-Commerce Delivery 2017 are from what industries	Logistics|Delivery_Service|Transportation
the exhibitor of Digital 2017 are from what industries	Mobile|Information_Technology|Automotive|Software|Test_and_Measurement|Analytics|Business_Intelligence|Service_Industry|Internet|Innovation_Management|Apps|Consulting
the exhibitor of PuneConect are from what industries	SMS|Mobile|Software|Customer_Service|Call_Center|Human_Computer_Interaction|Developer_Tools|Telecommunications|Cloud_Infrastructure
the exhibitor of Gartner Enterprise Application Strategy & Application Architecture Summit Tokyo 2018 are from what industries	Information_Technology|FinTech|Asset_Management|Virtualization|Operating_Systems|Developer_Platform|Big_Data|CRM|Consulting|Enterprise_Software|Financial_Services|Software|Publishing|Personal_Finance|Developer_Tools|Business_Development|Accounting|Cloud_Computing|Linux|Information_Services|Open_Source|Business_Information_Systems|PaaS|SaaS|Business_Intelligence|Data_Integration|Analytics|Finance|Enterprise_Resource_Planning_(ERP)|Computer
the exhibitor of RSA Conference 2021 are from what industries	Information_Technology|Security|Government|Data_Center_Automation|Big_Data|Compliance|Software|Digital_Media|Communication_Hardware|Infrastructure|Video_Streaming|Cloud_Security|Health_Care|Risk_Management|SaaS|Identity_Management|Telecommunications|Cyber_Security|Mobile|Analytics|Network_Security|Communications_Infrastructure|Computer
the exhibitor of Google Demo Day: Asia are from what industries	Electronics|Wellness|FinTech|E-Commerce|Virtualization|Machinery_Manufacturing|Fitness|Big_Data|Employee_Benefits|Enterprise_Software|Financial_Services|Software|Consumer_Electronics|Hospitality|Communication_Hardware|Robotics|Artificial_Intelligence|Machine_Learning|Insurance|Logistics|Virtual_Reality|B2B|Cloud_Data_Services|Health_Care|Space_Travel|Home_Decor|Construction|SaaS|Enterprise_Applications|Wearables|Manufacturing|Human_Resources|Virtual_World|Building_Material|Analytics|Product_Design|Finance|Air_Transportation|Transportation
the exhibitor of TechFestNW 2018 are from what industries	Social|Sports
the exhibitor of NRF 2019 Retail's Big Show & EXPO are from what industries	Information_Technology|Mining|Automotive|Security|FinTech|Advertising|Data_Visualization|E-Commerce|Oil_and_Gas|Ticketing|Internet|Social_Media|Big_Data|Enterprise_Software|Software|Consumer_Electronics|Mobile_Payments|Fashion|Artificial_Intelligence|Machine_Learning|Cloud_Security|Database|Logistics|Retail_Technology|Cloud_Data_Services|Hardware|E-Commerce_Platforms|SaaS|Audio|Manufacturing|Business_Intelligence|Cyber_Security|Mobile|Analytics|Social_Network|Transportation|Network_Security|Retail|Network_Hardware|Computer|Internet_of_Things
the exhibitor of Strata Data Conference New York are from what industries	Information_Technology|Electronics|B2C|Compliance|CRM|Events|Enterprise_Software|Software|Text_Analytics|Management_Consulting|Developer_Tools|Marketing|Cloud_Infrastructure|Database|Information_Services|Real_Time|Document_Management|Medical|Software_Engineering|Cloud_Management|Project_Management|Wireless|Data_Center|News|Finance|GPU|Computer|Web_Browsers|Security|Virtualization|Developer_Platform|Predictive_Analytics|Collaboration|Robotics|Artificial_Intelligence|Industrial|Cloud_Computing|Virtual_Reality|Apps|Cloud_Data_Services|Open_Source|Quality_Assurance|PaaS|Application_Performance_Management|Risk_Management|Public_Relations|Enterprise_Applications|Training|Business_Intelligence|Career_Planning|Data_Storage|IT_Management|Test_and_Measurement|Education|Web_Development|Data_Visualization|Data_Mining|Social_Media|Operating_Systems|Supply_Chain_Management|Big_Data|Publishing|Privacy|Dental|Machine_Learning|Retail_Technology|Productivity_Tools|Developer_APIs|Business_Information_Systems|Mobile|Enterprise|Data_Integration|Energy|Analytics|Network_Security|Communications_Infrastructure|Intelligent_Systems|Industrial_Automation|Professional_Services|E-Commerce|Internet|Data_Center_Automation|Consulting|Financial_Services|Digital_Media|Personal_Health|Natural_Language_Processing|Infrastructure|Accounting|Business_Development|Private_Cloud|Logistics|E-Learning|Search_Engine|EBooks|Hardware|Health_Care|SaaS|Cyber_Security|National_Security|Cloud_Storage|Product_Design|Internet_of_Things
the exhibitor of IoT Data & AI Summit are from what industries	Information_Technology|Electronics|Virtualization|Mobile_Devices|Big_Data|Predictive_Analytics|Consulting|Enterprise_Software|Software|Cloud_Infrastructure|B2B|Web_Hosting|Real_Time|Service_Industry|Telecommunications|Cyber_Security|Analytics|Wireless|Data_Center|Network_Security|Information_and_Communications_Technology_(ICT)|Internet_of_Things
the exhibitor of How to Enter the Food and Beverage Industry with Hojicha Co. are from what industries	Consumer_Goods|Food_and_Beverage|Tea|Wholesale
the exhibitor of Xilinx Developer Forum 2018 (Silicon Valley) are from what industries	Web_Development|Information_Technology|Electronics|Semiconductor|Internet|Supply_Chain_Management|Big_Data|Electrical_Distribution|Enterprise_Software|Software|Developer_Tools|Machine_Learning|Cloud_Computing|Information_Services|Application_Specific_Integrated_Circuit_(ASIC)|Hardware|Manufacturing|Field-Programmable_Gate_Array_(FPGA)|Data_Storage|Embedded_Software|Embedded_Systems|Internet_of_Things
the exhibitor of Hong Kong Trade Development Council Entrepreneur Day 2018 are from what industries	Parenting|Baby|Medical_Device|Health_Care|Personal_Health|Wellness|Biotechnology|Health_Diagnostics|Food_and_Beverage|Nutrition
