Gamma Medica launched funding rounds in what countries	USA
Flourish launched funding rounds in what countries	USA
Immersion Games launched funding rounds in what countries	POL
equell launched funding rounds in what countries	USA
BuildPass launched funding rounds in what countries	AUS
All Web Leads launched funding rounds in what countries	USA
Alta launched funding rounds in what countries	AUS
Epocal launched funding rounds in what countries	CAN
LoveRaw launched funding rounds in what countries	GBR
Severn Partnership launched funding rounds in what countries	GBR
Mersibo launched funding rounds in what countries	RUS
Victoury launched funding rounds in what countries	BEL
Enerskin launched funding rounds in what countries	USA
Locaid launched funding rounds in what countries	USA
OptioPay launched funding rounds in what countries	DEU
Attrackting launched funding rounds in what countries	CHE
Cartesian launched funding rounds in what countries	USA
MyFreightWorld launched funding rounds in what countries	USA
SubHub launched funding rounds in what countries	GBR
Anxa launched funding rounds in what countries	HKG
AIRSIS launched funding rounds in what countries	USA
Overleaf launched funding rounds in what countries	GBR
Australis Capital launched funding rounds in what countries	USA
Accio Robotics launched funding rounds in what countries	IND
Zoobean launched funding rounds in what countries	USA
Integral Spine Solutions launched funding rounds in what countries	USA
HUALALA launched funding rounds in what countries	CHN
Habito launched funding rounds in what countries	GBR
InfoMentor launched funding rounds in what countries	ISL
Aifred Health launched funding rounds in what countries	CAN
SEEVA Technologies launched funding rounds in what countries	USA
AMANATINFO launched funding rounds in what countries	USA
Conta√Ågil launched funding rounds in what countries	BRA
RedCircle launched funding rounds in what countries	USA
Citadon launched funding rounds in what countries	USA
Hafven launched funding rounds in what countries	DEU
Mizar Games launched funding rounds in what countries	CYP
NuLight launched funding rounds in what countries	CHL
Route42 launched funding rounds in what countries	NLD
Grand Energy launched funding rounds in what countries	USA
StruXure Outdoor launched funding rounds in what countries	USA
Chatwork launched funding rounds in what countries	JPN
Mazor launched funding rounds in what countries	ISR
Skritswap launched funding rounds in what countries	CAN
Ice Drink launched funding rounds in what countries	CHN
Houstronomy launched funding rounds in what countries	COL
Applicate launched funding rounds in what countries	IND
Bright Mind 3D launched funding rounds in what countries	ARE
WhistlePig launched funding rounds in what countries	USA
Valt.X Cyber Security launched funding rounds in what countries	USA
Ausha launched funding rounds in what countries	FRA
Phoenix Photonics launched funding rounds in what countries	GBR
TEACH launched funding rounds in what countries	CHN
Okena launched funding rounds in what countries	USA
Spartan Race launched funding rounds in what countries	USA
Exo Therapeutics launched funding rounds in what countries	USA
Drik launched funding rounds in what countries	USA
Lets Hash launched funding rounds in what countries	IND
Earnado launched funding rounds in what countries	TUR
Oodlz launched funding rounds in what countries	ISR
LYF Rescue Drone launched funding rounds in what countries	CHE
Adel launched funding rounds in what countries	IMN
B2C Europe launched funding rounds in what countries	NLD
B-PARTS.com launched funding rounds in what countries	PRT
Pixit launched funding rounds in what countries	FRA
M14 Industries launched funding rounds in what countries	GBR
Plexian launched funding rounds in what countries	SWE
KeenHub launched funding rounds in what countries	ITA
Una Tickets launched funding rounds in what countries	GBR
Nodin launched funding rounds in what countries	USA
Suppress X-S launched funding rounds in what countries	USA
Archimigo launched funding rounds in what countries	AUS
CMC launched funding rounds in what countries	CHN
jalebi launched funding rounds in what countries	ARE
IQNavigator launched funding rounds in what countries	USA
Game Server Services launched funding rounds in what countries	JPN
Utility and Environmental Solutions launched funding rounds in what countries	GBR
Kumuda launched funding rounds in what countries	USA
Breeze launched funding rounds in what countries	USA
nhentai launched funding rounds in what countries	USA
Iterex launched funding rounds in what countries	USA
Construyo launched funding rounds in what countries	DEU
PharmRight launched funding rounds in what countries	USA
Baochun Steel launched funding rounds in what countries	CHN
Axerra Networks launched funding rounds in what countries	ISR
Allegory Handcrafted Goods launched funding rounds in what countries	USA
CodePen launched funding rounds in what countries	USA
Maxwell Technologies launched funding rounds in what countries	USA
ROBOTPEN launched funding rounds in what countries	CHN
Care Interface launched funding rounds in what countries	USA
Humeixi launched funding rounds in what countries	CHN
SignD Identity launched funding rounds in what countries	AUT
Autotrip launched funding rounds in what countries	GBR
Argonaut Gold launched funding rounds in what countries	USA
Ion Torrent launched funding rounds in what countries	USA
TopHatch launched funding rounds in what countries	USA
EYWAMEDIA launched funding rounds in what countries	SGP
Webinfinity launched funding rounds in what countries	USA
Affect launched funding rounds in what countries	USA
Buy Local Canada launched funding rounds in what countries	CAN
