Olga Chumakova is the contestant of events in which countries	GBR|LVA|DEU|CHE|NLD|FRA|PRT
Dimitri Zlobin is the contestant of events in which countries	ESP
Richard Choo is the contestant of events in which countries	CHE
Dr James Kojian is the contestant of events in which countries	DEU|MEX|ARE
Daman Kalra is the contestant of events in which countries	TUR
Gary Manning is the contestant of events in which countries	CAN|USA
Marcela Kane Lantrip is the contestant of events in which countries	BRA
Claudia Rios is the contestant of events in which countries	USA
Pedro Renaud Anderson is the contestant of events in which countries	USA|GBR
Ryan Antrim is the contestant of events in which countries	USA|GBR
Maxim Gasumyants is the contestant of events in which countries	BGR
Spandana Govindgari is the contestant of events in which countries	USA
Ann Scango is the contestant of events in which countries	USA
Isaac Durá is the contestant of events in which countries	FIN
Nur Alfayez is the contestant of events in which countries	CHE
Patrick Rogosch is the contestant of events in which countries	DEU
Andy Chan is the contestant of events in which countries	SGP
Somdip Dey is the contestant of events in which countries	USA
Jonathan Richards is the contestant of events in which countries	USA
Timbo Drayson is the contestant of events in which countries	CHE
Igor Jablokov is the contestant of events in which countries	USA
Matthew Stenquist is the contestant of events in which countries	SWE
Kamrul Choudhury is the contestant of events in which countries	USA
Jim Huang is the contestant of events in which countries	TWN
Demetrios Zamboglou is the contestant of events in which countries	GBR
Samet ARABACIOĞLU is the contestant of events in which countries	PRT
Roald Sieberath is the contestant of events in which countries	USA
Chee How Lim is the contestant of events in which countries	CHE
Evran Mersin is the contestant of events in which countries	ITA
Senthil Padmanabhan is the contestant of events in which countries	USA
Faheem Saiyad is the contestant of events in which countries	IND|ARE
Emily Elwes is the contestant of events in which countries	FRA
Kamal Bouskri is the contestant of events in which countries	CHE
Richard Mokuolu is the contestant of events in which countries	USA
Niklas Barkmeyer is the contestant of events in which countries	GBR
Uchi Uchibeke is the contestant of events in which countries	CAN|USA
Alekh Barli is the contestant of events in which countries	ESP|DEU
Sagar Ratilal Bavarva is the contestant of events in which countries	PRT|NLD|USA
Akhil Pandey is the contestant of events in which countries	USA
Shivam Khandelwal is the contestant of events in which countries	IND
Jeremy Charoy is the contestant of events in which countries	FRA
Tarun Poddar is the contestant of events in which countries	MYS
David Gluckman is the contestant of events in which countries	CHE
Tarmo Korela is the contestant of events in which countries	USA
David Moeller is the contestant of events in which countries	USA
Albert Yu is the contestant of events in which countries	MAC
Brian Handrigan is the contestant of events in which countries	USA
Maria Ines Carrelli is the contestant of events in which countries	GBR|AUT|CHE|CZE|USA
Justin Wilson is the contestant of events in which countries	USA
Ricardo Uzcategui is the contestant of events in which countries	USA
Katherine Kuzmeskas is the contestant of events in which countries	USA
Sergey Vladimirov is the contestant of events in which countries	DEU|USA|AUT
Nasir Chowdhury is the contestant of events in which countries	BGD
Hansit Patel is the contestant of events in which countries	IND
Lucky Gupta is the contestant of events in which countries	IND
Karsten Guenther is the contestant of events in which countries	FRA|USA
Carol Riboud is the contestant of events in which countries	CHE
Suman Kumar is the contestant of events in which countries	IDN|IND
Clément Sauvage is the contestant of events in which countries	FRA|FIN
Gary McKay is the contestant of events in which countries	GBR
Davit Kocharyan is the contestant of events in which countries	CHE
Mathieu Habegger is the contestant of events in which countries	CHE
Thomas Balkizas MSC, MEng, MIoD is the contestant of events in which countries	USA
Azeez Arafath is the contestant of events in which countries	LKA
Askar Aituov is the contestant of events in which countries	USA
Veena Somareddy is the contestant of events in which countries	USA
Hemil Parekh is the contestant of events in which countries	ARE
David Tang is the contestant of events in which countries	USA
Esteban Chaves is the contestant of events in which countries	CHE|CRI
Rick Uzcategui is the contestant of events in which countries	USA
Mohamed Elwazer is the contestant of events in which countries	CHE
Andy Peart is the contestant of events in which countries	ESP
Saniya Shah is the contestant of events in which countries	USA
Nikunj Handa is the contestant of events in which countries	CHE
Dat Dinh Le is the contestant of events in which countries	SGP|USA
Travis Papenbrock is the contestant of events in which countries	USA
Mehmet Ali Peker is the contestant of events in which countries	TUR
Nadiya Sheckler is the contestant of events in which countries	USA
Paulius Jurcys is the contestant of events in which countries	USA
Furkan KAMACI is the contestant of events in which countries	TUR
Yoonchang Han is the contestant of events in which countries	FIN
Robert Brevelle is the contestant of events in which countries	USA
Joshua Michael Vignona is the contestant of events in which countries	USA
Alejandro Artacho is the contestant of events in which countries	ESP
Frank Camuso is the contestant of events in which countries	USA
Pablo Mayer is the contestant of events in which countries	CHE
Frank DeJoy is the contestant of events in which countries	USA
Aki Backman is the contestant of events in which countries	USA
Marc Rutzen is the contestant of events in which countries	USA
Paul Wang is the contestant of events in which countries	CHE
Bobby King is the contestant of events in which countries	USA
Manpreet Singh is the contestant of events in which countries	USA|IND
Choji Bare is the contestant of events in which countries	CHE
Hennadiy Netyaha is the contestant of events in which countries	CHN
Bernhard Hecker is the contestant of events in which countries	AUT
Viacheslav Semenikhin is the contestant of events in which countries	RUS|FIN
AMIT PATHAK is the contestant of events in which countries	USA
Conor McLaughlin is the contestant of events in which countries	USA
Lucas Hendren is the contestant of events in which countries	USA
Kyle Asman is the contestant of events in which countries	ARE
