the investors of Series A - Swap.com are from which countries	USA
the investors of Pre Seed Round - Clip Money Inc. are from which countries	USA
the investors of Pre Seed Round - GMTM are from which countries	USA
the investors of Series A - DealCloud are from which countries	USA
the investors of Series A - iList are from which countries	USA
the investors of Series B - Quantason are from which countries	USA
the investors of Seed Round - Curate are from which countries	USA
the investors of Series A - HODINKEE are from which countries	USA
the investors of Pre Seed Round - Live Furnish are from which countries	USA
the investors of Pre Seed Round - Ethale Books App are from which countries	GBR
the investors of Seed Round - Inspectiv are from which countries	USA
the investors of Convertible Note - Connect are from which countries	USA
the investors of Seed Round - Opium Protocol are from which countries	ITA
the investors of Seed Round - Omni are from which countries	USA
the investors of Seed Round - Trove are from which countries	USA
the investors of Series A - LockerDome are from which countries	CAN|USA
the investors of Pre Seed Round - Blanket are from which countries	USA
the investors of Pre Seed Round - Kloud.io are from which countries	USA
the investors of Series B - Fresha are from which countries	CHE
the investors of Seed Round - Mirum are from which countries	BRA
the investors of Seed Round - Hello Scout Inc. are from which countries	USA
the investors of Pre Seed Round - Frontline Investments India are from which countries	IND
the investors of Pre Seed Round - Underground Cellar are from which countries	USA
the investors of Series A - Cratejoy are from which countries	USA
the investors of Series A - Avail are from which countries	USA
the investors of Convertible Note - Fresha are from which countries	CHE
the investors of Seed Round - Capsul Jewelry are from which countries	USA
the investors of Seed Round - Level Travel are from which countries	RUS
the investors of Seed Round - Data Lake Shore are from which countries	USA
the investors of Seed Round - Forge are from which countries	USA
the investors of Pre Seed Round - Koloni are from which countries	USA
the investors of Seed Round - Cyclone Therapeutics are from which countries	GBR
the investors of Series A - Trove are from which countries	USA
the investors of Pre Seed Round - Musicasa are from which countries	USA
the investors of Seed Round - Dawai At Door are from which countries	PAK
the investors of Seed Round - SamBoad Travel and Educational Consult are from which countries	GHA
the investors of Seed Round - Skit are from which countries	IND
the investors of Series B - Cozy are from which countries	USA
the investors of Pre Seed Round - Steno are from which countries	USA
the investors of Seed Round - Britcan Media Limited are from which countries	CAN
the investors of Venture Round - CarForce are from which countries	USA
the investors of Series B - Yappli are from which countries	JPN
the investors of Series A - Gigster are from which countries	USA
the investors of Seed Round - BetterCompany are from which countries	USA
the investors of Series C - Sapiens Steering Brain Stimulation are from which countries	NLD
the investors of Pre Seed Round - GYANT are from which countries	DEU
the investors of Angel Round - RMI Insights are from which countries	USA
the investors of Series A - Wunderkind (formerly BounceX) are from which countries	USA
the investors of Series A - 5D Holdings LLC are from which countries	USA
the investors of Pre Seed Round - realxdata are from which countries	DEU
the investors of Series A - Image Space Media are from which countries	USA
the investors of Seed Round - BenchmarkONE are from which countries	USA
the investors of Venture Round - COOL WATCH are from which countries	TUR
the investors of Pre Seed Round - SmoothTerminal are from which countries	USA
the investors of Series A - Vendia are from which countries	ISR
the investors of Funding Round - Socent Studios are from which countries	USA
the investors of Pre Seed Round - Bling are from which countries	USA
the investors of Pre Seed Round - Players' Lounge are from which countries	USA
the investors of Funding Round - Polar are from which countries	USA
the investors of Seed Round - Trendalytics Innovation Labs are from which countries	USA
the investors of Seed Round - Stowaway Cosmetics are from which countries	USA
the investors of Seed Round - MM.LaFleur are from which countries	USA
the investors of Pre Seed Round - Teksun Inc are from which countries	USA
the investors of Seed Round - Ratter are from which countries	USA
the investors of Seed Round - Vectalys are from which countries	TUN
the investors of Series A - Mouth Foods are from which countries	USA
the investors of Pre Seed Round - axle ai are from which countries	USA
the investors of Private Equity Round - Infovys are from which countries	IND
the investors of Series A - Ease-Link GmbH are from which countries	GBR
the investors of Venture Round - Istegelsin are from which countries	TUR
the investors of Pre Seed Round - 1ID are from which countries	CAN
the investors of Venture Round - Oatly are from which countries	SGP
the investors of Pre Seed Round - ePilot Mobility are from which countries	DEU
the investors of Pre Seed Round - CultureForce are from which countries	USA
the investors of Pre Seed Round - Hank are from which countries	USA
the investors of Pre Seed Round - Ydistri are from which countries	HUN
the investors of Seed Round - tonebase are from which countries	USA
the investors of Funding Round - BootstrapLabs are from which countries	USA
the investors of Convertible Note - Wrapify are from which countries	USA
the investors of Pre Seed Round - FAVES are from which countries	USA
the investors of Seed Round - Butterfleye are from which countries	USA
the investors of Series B - Anyword are from which countries	USA
the investors of Private Equity Round - WTI (Western Telematic Inc) are from which countries	USA
the investors of Series A - FinLocker are from which countries	USA
the investors of Seed Round - Sorare are from which countries	ESP
the investors of Seed Round - WhereBy.Us are from which countries	USA
the investors of Series B - Trove are from which countries	USA
the investors of Series A - Dyspatch are from which countries	USA
the investors of Seed Round - DigiSure are from which countries	DEU|USA
the investors of Seed Round - Ampjar are from which countries	USA
the investors of Venture Round - MobileCoin are from which countries	USA
the investors of Seed Round - meaZr are from which countries	USA
the investors of Seed Round - BrandRep are from which countries	USA
the investors of Angel Round - GigIndia are from which countries	IND
the investors of Seed Round - Myro are from which countries	USA
the investors of Series C - Zenefits are from which countries	USA
the investors of Seed Round - Foodhive are from which countries	NGA
the investors of Pre Seed Round - Befundo.com are from which countries	NLD
the investors of Pre Seed Round - Scout are from which countries	USA
the investors of Seed Round - Votion are from which countries	USA
