the owner of TECH Fund launched which funding rounds	Series_B_-_LinkedIn@0cd8e|Secondary_Market_-_LinkedIn@d8318|Series_D_-_LinkedIn@f2fb3|Series_A_-_LinkedIn@bba89|Series_C_-_LinkedIn@c5724|Series_D_-_LinkedIn@e2937
the owner of Inaugural Sustainability Fund launched which funding rounds	Post-IPO_Debt_-_Cowen_Group@6fd7b
the owner of Virtus Real Estate Capital II launched which funding rounds	Debt_Financing_-_Virtus_Real_Estate_Capital@73e1b
the owner of Advantage Capital Community Development Fund launched which funding rounds	Debt_Financing_-_Advantage_Capital@40fc7
the owner of Clearbanc II launched which funding rounds	Series_C_-_Clearco@bf7ce|Series_C_-_Clearco@5421b|Series_A_-_Clearco@e0d9d|Series_B_-_Clearco@512ab|Debt_Financing_-_Clearco@11559
the owner of Redwood Japan Logistics Fund 2 launched which funding rounds	Funding_Round_-_e-Shang_Redwood_(ESR)@bfbb1|Private_Equity_Round_-_e-Shang_Redwood_(ESR)@6c033|Corporate_Round_-_e-Shang_Redwood_(ESR)@3ffea|Corporate_Round_-_e-Shang_Redwood_(ESR)@0203f
the owner of Vestar Capital Partners VII launched which funding rounds	Debt_Financing_-_Vestar_Capital_Partners@04b14|Venture_Round_-_Vestar_Capital_Partners@a344e
the owner of OPAL Fund, LP launched which funding rounds	Grant_-_Opportunity_Alabama@45bf1
the owner of BlackSoil India Credit Fund launched which funding rounds	Debt_Financing_-_BlackSoil@4dfb7|Series_C_-_BlackSoil@0a2a9|Debt_Financing_-_BlackSoil@9ef44|Venture_Round_-_BlackSoil@d0722
the owner of Cryptogon EOS LP launched which funding rounds	Initial_Coin_Offering_-_Block.one@fc923|Venture_Round_-_Block.one@dc375
the owner of gener8tor Fund II launched which funding rounds	Venture_Round_-_gener8tor@0e28b
the owner of Mirae Asset Project Planet Fund I launched which funding rounds	Debt_Financing_-_Mirae_Asset_Global_Investments@35337|Post-IPO_Equity_-_Mirae_Asset_Global_Investments@ddc6b
the owner of Energy IV launched which funding rounds	Private_Equity_Round_-_FourPoint_Energy@0adab|Funding_Round_-_FourPoint_Energy@53515
the owner of European mid-market fund launched which funding rounds	Venture_Round_-_Bregal_Investments@81155
the owner of DFJ Esprit III launched which funding rounds	Post-IPO_Debt_-_Molten_Ventures@b96c0|Post-IPO_Equity_-_Molten_Ventures@816d1
the owner of Controlled Environment Foods Fund II launched which funding rounds	Venture_Round_-_Equilibrium_Capital@1e097
the owner of FundersClub VD8 launched which funding rounds	Seed_Round_-_FundersClub@728ad
the owner of Chalkline Partners launched which funding rounds	Series_A_-_Chalkline@d181e|Seed_Round_-_Chalkline@179b9
the owner of NB Private Equity Credit Opportunities Fund launched which funding rounds	Post-IPO_Equity_-_Neuberger_Berman_Group@6036d
the owner of Castor Ventures Fund 5 launched which funding rounds	Seed_Round_-_Alumni_Ventures@25862
the owner of Infinity Group Holdings, L.P. launched which funding rounds	Funding_Round_-_New_Mountain_Capital@5713b
the owner of gener8tor Fund VII launched which funding rounds	Venture_Round_-_gener8tor@0e28b
the owner of LearnLaunch X launched which funding rounds	Seed_Round_-_LearnLaunch_Accelerator@6d4d4
the owner of Seed Fund launched which funding rounds	Venture_Round_-_Play2Live@068e9|Initial_Coin_Offering_-_Play2Live@32b2b
the owner of Hi Inov 1 launched which funding rounds	Seed_Round_-_Hi_Inov_-_Dentressangle@f9fc2
the owner of Rakuten Global Investment Fund launched which funding rounds	Post-IPO_Equity_-_Rakuten@5f150|Post-IPO_Equity_-_Rakuten@61362
the owner of 500 Durians II launched which funding rounds	Venture_Round_-_500_Startups@e444e|Venture_Round_-_500_Startups@ee38e
the owner of TPEG Overland Park Hotel Investors LLC launched which funding rounds	Private_Equity_Round_-_Trinity_Private_Equity_Group@40b19|Private_Equity_Round_-_Trinity_Private_Equity_Group@daaa1
the owner of Veritas Capital Fund VI LP launched which funding rounds	Debt_Financing_-_Veritas_Capital@c0f50
the owner of Leaf Holdings, LP launched which funding rounds	Venture_Round_-_Harbor_Group_International@3d3e0
the owner of Convergence Partners Communications Infrastructure Fund (Final Close) launched which funding rounds	Debt_Financing_-_Convergence_Partners@8b4f2
the owner of Nuvemshop Capital fund launched which funding rounds	Angel_Round_-_Nuvemshop@b90cc|Non_Equity_Assistance_-_Nuvemshop@45238|Series_E_-_Nuvemshop@1ac27|Seed_Round_-_Nuvemshop@ebbbe|Series_D_-_Nuvemshop@2ebcd|Series_C_-_Nuvemshop@f39d6|Seed_Round_-_Nuvemshop@65062|Series_B_-_Nuvemshop@e0c53
the owner of Emerging Africa Infrastructure Fund (EAIF) launched which funding rounds	Grant_-_Investec@f044f|Debt_Financing_-_Investec@1ee6b
the owner of India Infoline Wealth Management Realty Fund launched which funding rounds	Private_Equity_Round_-_IIFL_Investment_Managers@7f3f3
the owner of Pi Ventures Maiden Fund launched which funding rounds	Seed_Round_-_Pi_Ventures@0c9c2
the owner of Mass Ventures Equity Fund launched which funding rounds	Grant_-_MassVentures@41aad
the owner of Alchemist Accelerator US Fund II launched which funding rounds	Venture_Round_-_Alchemist_Accelerator@f3643|Venture_Round_-_Alchemist_Accelerator@58525|Venture_Round_-_Alchemist_Accelerator@3fadb|Venture_Round_-_Alchemist_Accelerator@f992b
the owner of TPEG FW Hotel launched which funding rounds	Private_Equity_Round_-_Trinity_Private_Equity_Group@40b19|Private_Equity_Round_-_Trinity_Private_Equity_Group@daaa1
the owner of Challenger 2 launched which funding rounds	Funding_Round_-_Startup_Wise_Guys@dfa1a
the owner of Advantage Capital Partners VII launched which funding rounds	Debt_Financing_-_Advantage_Capital@40fc7
the owner of WuXi Healthcare Venture Fund II launched which funding rounds	Venture_Round_-_WuXi_AppTec@a098d|Series_A_-_WuXi_AppTec@02175|Series_C_-_WuXi_AppTec@9faa4|Post-IPO_Equity_-_WuXi_AppTec@b2a19|Debt_Financing_-_WuXi_AppTec@e75d2
the owner of Capria Venture Fund launched which funding rounds	Debt_Financing_-_Capria_Ventures@b33d2
the owner of Investcorp Technology Partners IV launched which funding rounds	Seed_Round_-_Investcorp@36f66
the owner of Coastal Ventures IV LP launched which funding rounds	Venture_Round_-_CEI_Ventures@977b3|Debt_Financing_-_CEI_Ventures@7966a
the owner of Falcon Fund launched which funding rounds	Series_B_-_CrowdStrike@2a13f|Series_D_-_CrowdStrike@56603|Series_D_-_CrowdStrike@c0f66|Series_E_-_CrowdStrike@09a3f|Series_C_-_CrowdStrike@70705|Series_A_-_CrowdStrike@dc54c
the owner of Stonepeak Global Renewables Fund launched which funding rounds	Private_Equity_Round_-_Stonepeak_Infrastructure_Partners@67598
the owner of Veritas Capital Fund VII launched which funding rounds	Debt_Financing_-_Veritas_Capital@c0f50
the owner of NB Private equity co-investment fund II launched which funding rounds	Post-IPO_Equity_-_Neuberger_Berman_Group@6036d
the owner of FundersClub U26 LLC launched which funding rounds	Seed_Round_-_FundersClub@728ad
the owner of DXA Excelsior I launched which funding rounds	Private_Equity_Round_-_DXA_Invest@e4318
the owner of Warburg Pincus Global Growth, L.P. launched which funding rounds	Venture_Round_-_Warburg_Pincus@34486
the owner of Pi Labs fund III launched which funding rounds	Venture_Round_-_Pi_Labs@e03b9
the owner of Portfolia FirstStep Fund launched which funding rounds	Seed_Round_-_Portfolia@9af43
the owner of Seabury Partners VI launched which funding rounds	Venture_Round_-_Seabury_Group@885f8|Venture_Round_-_Seabury_Group@f850e
the owner of gener8tor Fund III launched which funding rounds	Venture_Round_-_gener8tor@0e28b
the owner of Exeter Property Group Fund III launched which funding rounds	Debt_Financing_-_Exeter_Property_Group@96f37
the owner of Sesame Street Seed Fund launched which funding rounds	Grant_-_Sesame_Street@b6944
the owner of Gravity Ventures Indiana V launched which funding rounds	Seed_Round_-_Gravity_Ventures@a28d8
the owner of SixThirty Cyber Fund launched which funding rounds	Venture_Round_-_SixThirty@3d094|Seed_Round_-_SixThirty@9d7d7
the owner of HGGC Fund II LP launched which funding rounds	Venture_Round_-_HGGC@590f1
the owner of Junos Innovation Fund launched which funding rounds	Post-IPO_Equity_-_Juniper_Networks@15967|Pre_Seed_Round_-_Juniper_Networks@1aff0|Post-IPO_Equity_-_Juniper_Networks@83432|Post-IPO_Equity_-_Juniper_Networks@8af2d
the owner of MDI-TMI Telkomsel Fund I launched which funding rounds	Series_B_-_MDI_Ventures@f4935
the owner of Fund I launched which funding rounds	Funding_Round_-_Draper_Goren_Holm@93ba3
the owner of CEIIF II launched which funding rounds	Series_B_-_CreditEase@cb11e|Series_A_-_CreditEase@894c6|Series_B_-_CreditEase@75a19
the owner of New Mountain Net Lease Partners launched which funding rounds	Funding_Round_-_New_Mountain_Capital@5713b
the owner of JumpStart Inc. Profit Venture Fund launched which funding rounds	Grant_-_JumpStart@91330
the owner of Fund II launched which funding rounds	Debt_Financing_-_Aero_Capital_Solutions@ee0e3
the owner of Oregon Angel Fund 2017 launched which funding rounds	Venture_Round_-_Oregon_Venture_Fund@f7ea7|Private_Equity_Round_-_Oregon_Venture_Fund@42f18|Private_Equity_Round_-_Oregon_Venture_Fund@aedec
the owner of LaunchVic Startup Fund launched which funding rounds	Grant_-_LaunchVic@eaed0
the owner of JJB Angel Fund launched which funding rounds	Series_B_-_Tilt@5568e|Series_A_-_Tilt@51b1e|Seed_Round_-_Tilt@e4353|Seed_Round_-_Tilt@a6b08|Series_B_-_Tilt@2c794
the owner of Triphammer Ventures Fund 3 launched which funding rounds	Seed_Round_-_Alumni_Ventures@25862
the owner of The Hainan Pictures Entertainment Industry Investment Fund launched which funding rounds	Post-IPO_Equity_-_Alibaba_Pictures@4bd1c
the owner of Oregon Angel Fund 2007 launched which funding rounds	Venture_Round_-_Oregon_Venture_Fund@f7ea7|Private_Equity_Round_-_Oregon_Venture_Fund@42f18|Private_Equity_Round_-_Oregon_Venture_Fund@aedec
the owner of Opportunistic Fund I launched which funding rounds	Series_B_-_Property_Partner@8a4bb|Seed_Round_-_Property_Partner@8ef21|Series_A_-_Property_Partner@94b87
the owner of Indiana Seed Fund III launched which funding rounds	Grant_-_BioCrossroads@a0453
the owner of ITU Ventures California I LP launched which funding rounds	Series_A_-_ITU_Ventures@a9271
the owner of Francisco Partners Credit Partners LP launched which funding rounds	Private_Equity_Round_-_Francisco_Partners@4f8bf
the owner of Second Music Royalties Fund launched which funding rounds	Series_C_-_Kobalt@1afc8|Series_B_-_Kobalt@8b59c|Series_D_-_Kobalt@86358|Series_D_-_Kobalt@84fd9|Series_B_-_Kobalt@cc884
the owner of NXT Capital Senior Loan Fund V launched which funding rounds	Venture_Round_-_NXT_Capital@cc4c4
the owner of Westwood Ventures Fund 2 launched which funding rounds	Seed_Round_-_Alumni_Ventures@25862
the owner of True Capital Partners Seed Fund launched which funding rounds	Venture_Round_-_True.@bbbd2
the owner of Coremine launched which funding rounds	Pre_Seed_Round_-_Messari@59118
the owner of Intermountain Healthcare Innovation Fund launched which funding rounds	Venture_Round_-_Healthbox@7c2de
the owner of Guardian Capital Ltd 60 % of outstanding shares launched which funding rounds	Seed_Round_-_ATK_Voting_Trust@67f33
the owner of Global Middle East Fund launched which funding rounds	Debt_Financing_-_Assiya_Capital_Partners@f89ff|Funding_Round_-_Assiya_Capital_Partners@16d78|Funding_Round_-_Assiya_Capital_Partners@6f8fa|Funding_Round_-_Assiya_Capital_Partners@b3920
the owner of H.I.G. Bayside Loan Opportunity Fund V launched which funding rounds	Venture_Round_-_H.I.G._Capital@f232c
the owner of Silver Lake Partners VI, L.P. launched which funding rounds	Private_Equity_Round_-_Silver_Lake@66841|Secondary_Market_-_Silver_Lake@ebc8f
the owner of SaltMines Group Seed I launched which funding rounds	Venture_Round_-_SaltMines_Group@12d46
the owner of TPEG Plato Investors launched which funding rounds	Private_Equity_Round_-_Trinity_Private_Equity_Group@40b19|Private_Equity_Round_-_Trinity_Private_Equity_Group@daaa1
the owner of EB 2000 launched which funding rounds	Venture_Round_-_Earlybird_Venture_Capital@41db1
the owner of Investcorp India-focused PE fund launched which funding rounds	Seed_Round_-_Investcorp@36f66
the owner of Invesco U.S. Income Fund launched which funding rounds	Post-IPO_Debt_-_Invesco@e2eb5
the owner of DSGCP Buildout II launched which funding rounds	Venture_Round_-_Apex_Fund_Services@7c3d7
the owner of Guardian Storage Greeley II launched which funding rounds	Venture_Round_-_Guardian_Storage@67dee|Venture_Round_-_Guardian_Storage@42ad0|Venture_Round_-_Guardian_Storage@696b6|Seed_Round_-_Guardian_Storage@52764|Seed_Round_-_Guardian_Storage@29c72|Venture_Round_-_Guardian_Storage@b3ee4|Venture_Round_-_Guardian_Storage@13654
the owner of TPEG Aventerra Investors LLC launched which funding rounds	Private_Equity_Round_-_Trinity_Private_Equity_Group@40b19|Private_Equity_Round_-_Trinity_Private_Equity_Group@daaa1
the owner of CapitaLand Asia Partners I (CAP I) launched which funding rounds	Post-IPO_Debt_-_CapitaLand@11a23|Post-IPO_Debt_-_CapitaLand@09e92|Post-IPO_Debt_-_CapitaLand@5a143|Post-IPO_Debt_-_CapitaLand@f85ff
the owner of Partners Group Global Infrastructure 2012 launched which funding rounds	Post-IPO_Equity_-_Partners_Group@72c25
the owner of Social Business Fund I launched which funding rounds	Grant_-_Grameen_America@e96c9|Venture_Round_-_Grameen_America@6dc8f
the owner of Warburg Pincus Financial Sector launched which funding rounds	Venture_Round_-_Warburg_Pincus@34486
the owner of London property fund launched which funding rounds	Private_Equity_Round_-_Astarte_Capital_Partners@142ed
