the sponsors of The Startup Conference 2016 are from what industries	Web_Browsers|Information_Technology|E-Commerce|Venture_Capital|Government|Internet|Women's|Incubators|Consulting|Enterprise_Software|Innovation_Management|Insurance|Business_Development|Online_Portals|Property_Development|Commercial_Real_Estate|EdTech|Training|Coworking|Communities|Real_Estate|Association|Non_Profit|Education
the sponsors of Virtual AI Expo are from what industries	Enterprise_Software|Information_Technology|Financial_Services|Banking|Analytics|Software|Text_Analytics|Information_Services|News|Venture_Capital|Natural_Language_Processing|Finance|Social_Media|Developer_Tools|Network_Security|Predictive_Analytics|Crowdsourcing
the sponsors of Monitorama USA are from what industries	Web_Development|Information_Technology|Security|Messaging|Internet|Enterprise_Software|Software|Collaboration|Content_Delivery_Network|Developer_Tools|Machine_Learning|Cloud_Security|Cloud_Infrastructure|Cloud_Computing|Productivity_Tools|Developer_APIs|SaaS|IT_Infrastructure|Mobile|Technical_Support|IT_Management|Project_Management|Analytics
the sponsors of nginx.conf 2016 are from what industries	Information_Technology|Automotive|Application_Performance_Management|Infrastructure|Cloud_Infrastructure|Information_Services
the sponsors of SearchFest 2016 are from what industries	Email_Marketing|Professional_Services|Marketing_Automation|Event_Management|Advertising|Creative_Agency|E-Commerce|Messaging|Internet|Email|Social_Media|Brand_Marketing|Operating_Systems|Big_Data|Consulting|CRM|Enterprise_Software|Vertical_Search|Software|Digital_Media|Content_Marketing|Natural_Language_Processing|Artificial_Intelligence|Management_Consulting|Developer_Tools|Marketing|Product_Search|Search_Engine|Digital_Marketing|SaaS|SEM|SEO|Mobile|Social_Media_Marketing|Knowledge_Management|Analytics|News|Direct_Marketing
the sponsors of PODIM Conference 2015 are from what industries	Financial_Services|Banking
the sponsors of Orlando Tech Week are from what industries	Information_Technology|Advertising|E-Commerce|CRM|Consulting|Software|Publishing|Hospitality|Recruiting|Robotics|Marketing|B2B|Health_Care|Employment|Real_Time|EdTech|Medical|Telecommunications|Mobile|Human_Resources|Medical_Device|Association|Non_Profit|Retail
the sponsors of O'Reilly Open Source Convention Portland 2018 are from what industries	Web_Development|Information_Technology|Electronics|Credit_Cards|Automotive|Sales|Security|FinTech|Advertising|E-Commerce|Virtualization|Internet|Operating_Systems|Developer_Platform|Big_Data|CRM|Enterprise_Software|Financial_Services|Software|Consumer_Electronics|Mobile_Payments|Recruiting|Payments|Developer_Tools|Business_Development|Marketing|E-Learning|Cloud_Computing|Linux|Information_Services|Search_Engine|Cloud_Data_Services|Open_Source|Ad_Network|Banking|PaaS|Business_Information_Systems|Hardware|Health_Care|Home_Decor|E-Commerce_Platforms|Web_Hosting|SaaS|Digital_Marketing|Telecommunications|Auctions|Transaction_Processing|Cyber_Security|Project_Management|Analytics|Wireless|Home_and_Garden|Finance|Non_Profit|Education|Network_Security|Information_and_Communications_Technology_(ICT)|Retail
the sponsors of Hub2014 are from what industries	Enterprise_Software|Information_Technology|Financial_Services|Professional_Services|Analytics|CRM|Construction|SaaS|Outsourcing|Management_Consulting|Accounting|Marketing|Consulting
the sponsors of Internet of Things World Europe are from what industries	Information_Technology|Electronics|Automotive|Security|Professional_Services|Semiconductor|Public_Safety|Internet|Enterprise_Software|Software|Digital_Media|Smart_Building|Payments|Industrial|Innovation_Management|Smart_Home|Information_Services|Cloud_Data_Services|Hardware|Health_Care|Industrial_Manufacturing|Consumer|Telecommunications|Communities|Manufacturing|Business_Intelligence|Mobile|Medical_Device|Energy|Analytics|Embedded_Software|Wireless|Real_Estate|Renewable_Energy|Association|Non_Profit|Air_Transportation|Network_Security|Communications_Infrastructure|Education|Computer|Internet_of_Things
the sponsors of Microbiome Human Nutrition Summit are from what industries	Information_Technology|Health_Care|Packaging_Services|Biotechnology|Market_Research|Medical|Bioinformatics|Consulting
the sponsors of Oracle Openworld 2017 are from what industries	Information_Technology|Electronics|Industrial_Automation|Professional_Services|Security|Virtualization|Internet|Supply_Chain_Management|Mobile_Devices|Big_Data|Advice|Consulting|CRM|Enterprise_Software|Electrical_Distribution|Financial_Services|Software|Legal|Artificial_Intelligence|Infrastructure|Outsourcing|Management_Consulting|Accounting|Business_Development|Cloud_Infrastructure|Database|Innovation_Management|Cloud_Computing|Information_Services|Insurance|Flash_Storage|Cloud_Data_Services|Business_Information_Systems|Hardware|Risk_Management|Enterprise_Resource_Planning_(ERP)|Construction|SaaS|Service_Industry|IT_Infrastructure|Telecommunications|Business_Intelligence|Mobile|Enterprise|IT_Management|Data_Integration|Analytics|Wireless|Data_Center|News|Product_Design|Wealth_Management|Finance|Association|Lighting|Network_Security|Information_and_Communications_Technology_(ICT)|Computer
the sponsors of Next Generation Optical Networking Asia are from what industries	Enterprise_Software|Information_Technology|Software|Hardware|Product_Design|Artificial_Intelligence|Developer_Tools|Operating_Systems|Database
the sponsors of Choosing the Best Payment Platform for Your eCommerce or SaaS Business are from what industries	Information_Technology|Big_Data|Financial_Services|Security|Software|Mobile_Payments|FinTech|Business_Intelligence|E-Commerce|SaaS|Payments|Identity_Management|Finance|Apps|Point_of_Sale|Compliance|Transaction_Processing
the sponsors of Tech.Coâ€™s Startup Night at SXSW 2016 are from what industries	Enterprise_Software|Business_Information_Systems|Software|Analytics|Data_Center|SaaS|Business_Development|Database|Cloud_Computing|CRM
the sponsors of DiG Publishing Lisbon 2018 are from what industries	Content_Discovery|Web_Development|Information_Technology|Security|Broadcasting|Ad_Targeting|Advertising|Creative_Agency|Data_Mining|Data_Visualization|Internet|Social_Media|Brand_Marketing|Big_Data|Advertising_Platforms|Compliance|Enterprise_Software|Mobile_Apps|Video_on_Demand|Software|Digital_Media|Publishing|Collaboration|Content_Marketing|Artificial_Intelligence|Privacy|Video_Streaming|Content|Marketing|Machine_Learning|Cloud_Computing|Information_Services|Ad_Server|Ad_Retargeting|Search_Engine|Ad_Network|Social_News|Digital_Marketing|Video_Editing|Hardware|Real_Time|SaaS|Media_and_Entertainment|Video|Content_Creators|Cyber_Security|Mobile|iOS|Analytics|A/B_Testing|News|Mobile_Advertising|Retail
the sponsors of StartUp Tour 2018 New York are from what industries	Social_Entrepreneurship|Information_Technology|FinTech|Asset_Management|Intellectual_Property|Venture_Capital|Social_Media|Incubators|Consulting|Enterprise_Software|Mobile_Apps|Financial_Services|Software|Publishing|Mobile_Payments|Hospitality|Business_Development|Insurance|In-Flight_Entertainment|EBooks|Professional_Networking|SaaS|Service_Industry|Travel|IT_Management|Journalism|News|Finance|Transportation|Retail
the sponsors of The Tapia 2016 Conference are from what industries	Communities|Education
the sponsors of Berlin Expert Days 2015 are from what industries	SMS|Information_Technology|Advertising|E-Commerce|Messaging|Internet|Mobile_Devices|Predictive_Analytics|Shopping|Consulting|Enterprise_Software|Mobile_Apps|Software|Digital_Media|Consumer_Electronics|Mobile_Payments|Publishing|Robotics|Small_and_Medium_Businesses|Developer_Tools|Innovation_Management|Marketing|Coupons|Developer_APIs|Open_Source|Digital_Marketing|SaaS|UX_Design|Training|Manufacturing|Software_Engineering|Mobile|Human_Resources|IT_Management|Data_Integration|Price_Comparison|News|Mobile_Advertising|Blockchain|Retail
the sponsors of Anne Arundel TechBreakfast are from what industries	Information_Technology|Cloud_Data_Services|Software|File_Sharing|Messaging|Non_Profit|Computer
the sponsors of Chief Data & Analytics Officers Fall 2020 are from what industries	Data_Integration|Analytics|Software|Test_and_Measurement|SaaS|Data_Center_Automation|Big_Data|Business_Intelligence
the sponsors of iMedia Commerce Summit are from what industries	Retail|Travel|Mobile|Advertising|E-Commerce|Mobile_Advertising|Product_Search|Advertising_Platforms
the sponsors of AngelHack Quito 2016 are from what industries	Web_Development|Developer_APIs|Mobile|Information_Technology|Enterprise_Software|IT_Management|Software|Hardware|Wireless|Cloud_Computing|Data_Center|Art|Telecommunications|Network_Security|Information_Services
the sponsors of Startup Iceland 2018 are from what industries	Tourism|Information_Technology|Professional_Services|FinTech|Government|Internet|Consulting|Financial_Services|Accounting|Information_Services|Marketplace|Biotechnology|Telecommunications|Travel|Mobile|Real_Estate|Finance|Pharmaceutical|Association|Education
the sponsors of World Blockchain Forum London 2018 are from what industries	Cyber_Security|Social_Entrepreneurship|Information_Technology|Financial_Services|Fantasy_Sports|Sports|Software|Digital_Entertainment|Social_Impact|Blockchain|Finance|Business_Development|Identity_Management|Computer
the sponsors of Citrix Synergy 2016 are from what industries	Cyber_Security|Enterprise_Software|Information_Technology|IT_Management|Software|Hardware|Consumer_Electronics|Wireless|Data_Center|Virtualization|Product_Design|Artificial_Intelligence|Virtual_Reality|Cloud_Security|Network_Security|Apps|GPU|Computer
the sponsors of MergeLane 2015 Demo Day are from what industries	Enterprise_Software|Mobile|Analytics|Hardware|Publishing|Advertising|Consumer|Internet|Telecommunications|Marketing
the sponsors of SMXL Milan are from what industries	SEO|SaaS|Content_Marketing|Digital_Marketing
the sponsors of Internet of Things Training at Intellisoft Singapore (90% WSQ Funded*) are from what industries	Education
the sponsors of Redefining Early Stage Investments are from what industries	Financial_Services|Health_Care|Genetics|Product_Research|Biotechnology|Medical|Finance|Non_Profit|Innovation_Management|Association|Business_Development|Insurance
the sponsors of FFL Startup Showcase: 2017 Fall Class are from what industries	Professional_Services|Banking|Financial_Services|Legal|Law_Enforcement|Finance|Advice
the sponsors of Finance 2.0 2019 are from what industries	Universities|Information_Technology|Financial_Services|Banking|Software|Impact_Investing|Asset_Management|Construction|Venture_Capital|Wealth_Management|Outsourcing|Association|Finance|Commercial_Lending|Consulting
the sponsors of Digital Finance World 2017 are from what industries	Enterprise_Software|Mobile|Information_Technology|Cyber_Security|Security|Software|Blockchain|Internet|Web_Design|Information_Services|Consulting
the sponsors of Code on the Beach are from what industries	Web_Development|Mobile|Software|Analytics|Health_Care|E-Commerce_Platforms|Content_Marketing|CMS|Fitness|Hospital|Content|Cloud_Computing
the sponsors of ODSC Europe 2020 Virtual Conference are from what industries	Social_Entrepreneurship|Information_Technology|Automotive|Data_Visualization|Advertising|Venture_Capital|Predictive_Analytics|Big_Data|Clean_Energy|CRM|Events|Food_Processing|Enterprise_Software|Lead_Generation|Financial_Services|Software|Digital_Media|Customer_Service|Legal|Recruiting|Collaboration|AgTech|Image_Recognition|Natural_Language_Processing|Artificial_Intelligence|Small_and_Medium_Businesses|Developer_Tools|Business_Development|Machine_Learning|Accounting|Database|Marketing|Cloud_Computing|Apps|Content|E-Learning|Search_Engine|Open_Source|Cloud_Data_Services|B2B|Digital_Marketing|Business_Information_Systems|Banking|Risk_Management|EBooks|SaaS|Coworking|Communities|Business_Intelligence|Location_Based_Services|Data_Storage|Data_Integration|Analytics|Computer_Vision|Real_Estate|Renewable_Energy|Agriculture|Geospatial|Education|Crowdsourcing
the sponsors of AngelHack Manila 2016 are from what industries	Web_Development|Information_Technology|Social_Media|Art|Augmented_Reality|Enterprise_Software|Software|Cloud_Computing|Information_Services|Virtual_Reality|Developer_APIs|Hardware|Telecommunications|Coworking|Mobile|IT_Management|Wireless|Data_Center|Social_Network|Network_Security
the sponsors of 12th National Digital Conference 2017 - Leading Digital Transformation are from what industries	Enterprise_Software|Information_Technology|Cloud_Data_Services|Financial_Services|Banking|Software|Health_Care|Analytics|Knowledge_Management|Data_Center|Government|Internet|Outsourcing|Finance|Insurance|Training|Education|Consulting
the sponsors of ConfigManagementCamp are from what industries	Information_Technology|Data_Center_Automation|Internet|Brand_Marketing|Operating_Systems|Consulting|Enterprise_Software|Software|Content_Marketing|Infrastructure|Cloud_Security|Cloud_Infrastructure|Information_Services|Cloud_Computing|Linux|Open_Source|Application_Performance_Management|SaaS|IT_Infrastructure|Enterprise_Applications|Training|Cloud_Management|Cyber_Security|IT_Management|Internet_of_Things
the sponsors of StartCon 2018 are from what industries	Web_Development|Social_Entrepreneurship|Information_Technology|Corporate_Training|Advertising|E-Commerce|Venture_Capital|Internet|Email|Angel_Investment|Incubators|CRM|Consulting|Universities|Enterprise_Software|Financial_Services|Software|Outsourcing|Business_Development|Marketing|Innovation_Management|Information_Services|Marketplace|Business_Information_Systems|SaaS|Solar|Crowdsourcing|Peer_to_Peer|Training|Communities|Business_Intelligence|Cloud_Management|Enterprise|Energy|Analytics|Renewable_Energy|Finance|Non_Profit|Social_Network|E-Signature|Education|Computer
the sponsors of Liveworx 2019 are from what industries	Information_Technology|Electronics|DSP|Advice|CRM|Enterprise_Software|CAD|Mobile_Apps|Software|Outsourcing|Developer_Tools|Management_Consulting|Insurance|Marketing|Database|Information_Services|3D_Technology|Real_Time|IT_Infrastructure|Wearables|Manufacturing|Software_Engineering|Travel|iOS|Embedded_Software|Wireless|Data_Center|News|Autonomous_Vehicles|Lighting|Information_and_Communications_Technology_(ICT)|Retail|Computer|Tourism|Security|Semiconductor|Virtualization|Messaging|Developer_Platform|Incubators|Collaboration|Robotics|Fashion|Artificial_Intelligence|Industrial|Cloud_Computing|Apps|Virtual_Reality|Enterprise_Applications|Training|Video|Business_Intelligence|Sales_Automation|IT_Management|Computer_Vision|Enterprise_Resource_Planning_(ERP)|Automotive|Asset_Management|Data_Visualization|Augmented_Reality|Operating_Systems|Supply_Chain_Management|Big_Data|Life_Science|Publishing|Consumer_Electronics|Hospitality|Customer_Service|Innovation_Management|Machine_Learning|Business_Information_Systems|Construction|Social|Service_Industry|Simulation|Transaction_Processing|Mobile|Enterprise|Data_Integration|Mechanical_Engineering|Analytics|Video_Games|Association|Non_Profit|Transportation|Embedded_Systems|Network_Security|Industrial_Automation|Professional_Services|Industrial_Design|Industrial_Engineering|Advertising|E-Commerce|Internet|Consulting|Financial_Services|Legal|Social_Impact|Accounting|Business_Development|Consumer_Reviews|Hardware|Content_Syndication|SaaS|Telecommunications|Communities|Cyber_Security|Cloud_Storage|Quantum_Computing|Internet_of_Things
the sponsors of SharePoint Fest Chicago 2018 are from what industries	Cloud_Management|Information_Technology|Software|Risk_Management|SaaS|Enterprise_Applications|Cloud_Security|Compliance
the sponsors of Tech Demo Night are from what industries	SMS|Enterprise_Software|Mobile_Apps|Information_Technology|Software|Analytics|Publishing|E-Commerce|SaaS|Messaging|Consumer|Internet|News|UX_Design|Marketing
the sponsors of Teradata Partners Conference 2017 are from what industries	Cloud_Data_Services|Data_Integration|Quality_Assurance|Analytics|Test_and_Measurement|Data_Visualization|Database|Big_Data|Business_Intelligence
the sponsors of Global Ventures Summit are from what industries	Food_Delivery|Transportation|E-Commerce|Payments|Consumer_Applications|Logistics
the sponsors of FinTech & InsurTech 2018 are from what industries	Analytics|Software|Information_Technology|Big_Data
the sponsors of IT/Dev Connections 2017 are from what industries	Information_Technology|Supply_Chain_Management|Big_Data|Enterprise_Software|Software|Consumer_Electronics|Developer_Tools|Flash_Storage|Cloud_Computing|Apps|Hardware|Web_Hosting|SaaS|Document_Management|IT_Infrastructure|Manufacturing|Enterprise|Data_Storage|Analytics|Wholesale
the sponsors of DevFest Nantes 2017 are from what industries	Enterprise_Software|Reservations|Information_Technology|Search_Engine|Data_Integration|Vertical_Search|Software|Hospitality|Cloud_Computing|Collaboration|Internet|Semantic_Search|Restaurants|Apps|Big_Data|Consulting
the sponsors of MODELSWARD 2016 are from what industries	Information_Technology|Professional_Services|Analytics|Software|Robotics|Communities|Consulting
the sponsors of Business Intelligence, Big Data, and Data Warehousing 2015 are from what industries	B2B|Training|Information_Technology|Project_Management|Corporate_Training|Knowledge_Management|Software|Coworking|E-Learning|Apps|Education|Consulting
the sponsors of Silicon Valley 2022 Venture Capital World Summit are from what industries	Publishing|Advertising
the sponsors of PULSE 2018 are from what industries	Retail|Information_Technology|Professional_Services|Unified_Communications|Marketing_Automation|Sales|Advertising|Internet|Email|Brand_Marketing|Big_Data|CRM|Consulting|Enterprise_Software|Social_CRM|Lead_Generation|Software|Customer_Service|Recruiting|Collaboration|Small_and_Medium_Businesses|Artificial_Intelligence|Outsourcing|Developer_Tools|Management_Consulting|Machine_Learning|E-Learning|Cloud_Computing|Apps|Information_Services|B2B|Guides|Hardware|Construction|Social|SaaS|Service_Industry|Training|Communities|SEO|Cloud_Management|Mobile|Human_Resources|Data_Integration|Social_Media_Marketing|Project_Management|Analytics|Product_Design|Market_Research|Association|Product_Management|Communications_Infrastructure|Education
the sponsors of UploadVR are from what industries	Retail|Information_Technology|Electronics|Automotive|Industrial_Engineering|Ediscovery|Data_Visualization|E-Commerce|Sensor|Virtualization|Internet|Augmented_Reality|Developer_Platform|Mobile_Devices|Enterprise_Software|Mobile_Apps|Software|Digital_Media|Consumer_Electronics|Image_Recognition|Artificial_Intelligence|Industrial|Machine_Learning|Apps|Virtual_Reality|Retail_Technology|Cryptocurrency|Visual_Search|Personalization|Hardware|3D_Technology|SaaS|Telecommunications|Wearables|Training|Manufacturing|Mobile|Consumer_Goods|Mechanical_Engineering|Wireless|Eyewear|Product_Design|Market_Research|Delivery|Blockchain|Ethereum|Network_Security|Education|Internet_of_Things
the sponsors of MuleSoft Connect Sydney 2019 are from what industries	Enterprise_Software|Mobile|Information_Technology|Industrial_Automation|IT_Management|Software|Business_Information_Systems|Cloud_Computing|Social|News|Collaboration|Service_Industry|SaaS|Association|Innovation_Management|Information_Services|Consulting
the sponsors of White Bull Summit TechChampions 2015 - Stockholm are from what industries	Information_Technology|Web_Hosting|Virtualization|Venture_Capital|Finance|Business_Development|Cloud_Computing
the sponsors of What's Up with Apple are from what industries	Information_Technology|Education|Non_Profit
the sponsors of Ask a VC Boston: 20+ Investors and You! are from what industries	Professional_Services|Building_Material|Project_Management|Legal|Real_Estate|Law_Enforcement|Advice|Consulting
the sponsors of AWS re:Invent are from what industries	Android|Information_Technology|Electronics|Compliance|Management_Information_Systems|CRM|Enterprise_Software|Mobile_Apps|Software|Outsourcing|Developer_Tools|Management_Consulting|Cloud_Infrastructure|Database|Information_Services|Linux|IT_Infrastructure|Cloud_Management|iOS|Project_Management|PC_Games|Data_Center|News|Finance|Computer|SMS|Security|Virtualization|Messaging|Developer_Platform|Predictive_Analytics|Robotics|Collaboration|Artificial_Intelligence|Video_Streaming|Content|Cloud_Security|Cloud_Computing|Apps|Open_Source|Cloud_Data_Services|PaaS|Business_Intelligence|IT_Management|Data_Storage|Social_Network|Enterprise_Resource_Planning_(ERP)|Billing|Web_Development|Government|Operating_Systems|Big_Data|Consumer_Electronics|Productivity_Tools|Developer_APIs|Construction|Web_Hosting|Service_Industry|Mobile|Data_Integration|Analytics|Video_Games|Network_Security|Communications_Infrastructure|Intelligent_Systems|Industrial_Automation|Professional_Services|File_Sharing|Venture_Capital|Internet|Consulting|Financial_Services|Content_Delivery_Network|Infrastructure|Private_Cloud|IaaS|Search_Engine|Hardware|SaaS|Telecommunications|Cyber_Security|National_Security|Cloud_Storage|Product_Design
the sponsors of RSA Conference 2018 are from what industries	Content_Discovery|Information_Technology|Private_Social_Networking|Compliance|Management_Information_Systems|CRM|Events|Advice|Enterprise_Software|Mobile_Apps|Software|Communication_Hardware|Developer_Tools|Insurance|Cloud_Infrastructure|Database|Information_Services|Audio|Manufacturing|Software_Engineering|Cloud_Management|Wireless|News|Data_Center|Finance|Information_and_Communications_Technology_(ICT)|Computer|Security|Semiconductor|Virtualization|Physical_Security|Continuing_Education|Developer_Platform|Predictive_Analytics|Collaboration|Robotics|Artificial_Intelligence|Video_Streaming|Content|Cloud_Security|Cloud_Computing|Apps|Open_Source|Cloud_Data_Services|Homeland_Security|Risk_Management|Industrial_Manufacturing|Enterprise_Applications|Training|Business_Intelligence|IT_Management|Data_Storage|Architecture|Enterprise_Resource_Planning_(ERP)|Education|FinTech|Government|Social_Media|Intrusion_Detection|Operating_Systems|Big_Data|Consumer_Electronics|Privacy|Innovation_Management|Machine_Learning|Business_Information_Systems|Web_Hosting|Consumer|Transaction_Processing|Mobile|Fraud_Detection|Enterprise|Analytics|Association|Non_Profit|Transportation|Network_Security|Identity_Management|Communications_Infrastructure|Intelligent_Systems|Navigation|Ediscovery|Aerospace|Professional_Services|Advertising|Internet|Email|Mobile_Devices|Consulting|Financial_Services|Digital_Media|Legal|Natural_Language_Processing|Infrastructure|Virtual_Desktop|Business_Development|Search_Engine|Hardware|Health_Care|SaaS|Telecommunications|Communities|Cyber_Security|National_Security|Product_Design|Speech_Recognition|Internet_of_Things
the sponsors of HPE Discover 2018 are from what industries	Information_Technology|Automotive|Professional_Services|Security|Semiconductor|File_Sharing|Oil_and_Gas|Virtualization|Data_Center_Automation|Supply_Chain_Management|Big_Data|Management_Information_Systems|Consulting|Enterprise_Software|Electrical_Distribution|Financial_Services|Software|Robotics|Infrastructure|Outsourcing|Accounting|Private_Cloud|Cloud_Infrastructure|Database|Insurance|Cloud_Computing|Apps|Cloud_Data_Services|Open_Source|Hardware|Construction|Web_Hosting|SaaS|Service_Industry|Enterprise_Applications|Telecommunications|VoIP|Business_Intelligence|Cyber_Security|Mobile|Chemical|Data_Storage|IT_Management|Cloud_Storage|Analytics|Data_Integration|Energy|Wireless|News|Video_Games|Data_Center|Lighting|Network_Security|Communications_Infrastructure
the sponsors of TechCrunch Disrupt Europe 2014: London are from what industries	SMS|Web_Development|Information_Technology|Professional_Services|Event_Management|FinTech|Data_Visualization|E-Commerce|Venture_Capital|Messaging|Government|Internet|Mapping_Services|Angel_Investment|Social_Media|GovTech|Big_Data|Information_and_Communications_Technology_(ICT)|Events|Consulting|Enterprise_Software|Financial_Services|Software|Digital_Media|Legal|Recruiting|Collaboration|Industrial|Developer_Tools|Cloud_Infrastructure|Cloud_Computing|Developer_APIs|CivicTech|Commercial_Real_Estate|3D_Technology|Construction|Web_Hosting|SaaS|EdTech|Telecommunications|Cloud_Management|Mobile|Career_Planning|Human_Resources|Analytics|Real_Estate|Data_Center|News|Architecture|Finance|Association|E-Signature|Identity_Management|Education|Computer|Internet_of_Things
the sponsors of Designing Connected Products: Talks by Kickstarter and Map are from what industries	Web_Development|Information_Technology|Software|FinTech|Product_Design|Artificial_Intelligence|Finance|UX_Design|Web_Design|Funding_Platform|Crowdfunding|Education|Crowdsourcing
the sponsors of AlterConf Chicago are from what industries	Web_Development|Information_Technology|Email_Marketing|E-Commerce|Virtualization|Internet|Web_Design|Events|Consulting|Mobile_Apps|Software|Cloud_Computing|Apps|Open_Source|Web_Hosting|SaaS|Video|Communities|iOS|Analytics|News
the sponsors of Big Data & Analytics for Banking Summit New York 2017 are from what industries	Information_Technology|Data_Storage|Analytics|Digital_Media|Software|Information_Services|Cloud_Computing|Big_Data|CRM
the sponsors of 1er Growth Hacking Summit IberoamÃ©rica are from what industries	Software|Web_Development|Mobile_Apps|Banking
the sponsors of EEC15 are from what industries	Web_Development|Information_Technology|FinTech|Advertising|E-Commerce|Internet|Semantic_Search|Consulting|Enterprise_Software|Credit|Financial_Services|Software|Collaboration|Content_Marketing|Payments|Outsourcing|Marketing|Content|Search_Engine|B2B|Digital_Marketing|Banking|Construction|Web_Hosting|SaaS|Public_Relations|Telecommunications|TV|SEO|Social_Media_Marketing|Data_Integration|Analytics|Market_Research|Finance
the sponsors of SoftLayer Startup Socials Mixer San Francisco are from what industries	Enterprise_Software|Mobile|Automotive|Digital_Media|Hardware|Employment|E-Commerce|Venture_Capital|News|EdTech|Finance|Angel_Investment|Association|Women's|Education|Incubators|Events|Internet_of_Things
the sponsors of World Economic Forum Annual Meeting 2015 are from what industries	Information_Technology|Electronics|Personal_Branding|Consulting|Financial_Services|Software|Consumer_Electronics|Innovation_Management|Insurance|Information_Services|Banking|Medical|Telecommunications|IT_Management|Financial_Exchanges|Agriculture|Finance|Wealth_Management|Advanced_Materials|Network_Security
the sponsors of Techonomy 2014 are from what industries	Information_Technology|Automotive|E-Commerce|Venture_Capital|Virtualization|Internet|Consulting|Financial_Services|Software|Collaboration|Management_Consulting|Business_Development|Cloud_Security|Cloud_Infrastructure|Cloud_Computing|Search_Engine|Marketplace|IT_Infrastructure|Telecommunications|Auctions|Manufacturing|Cloud_Management|Mobile|Data_Storage|Cloud_Storage|Autonomous_Vehicles|Finance|Transportation|Retail
the sponsors of Startup Weekend Chicago - Creative Enterprise Edition 2017 are from what industries	Universities|Training|Education
the sponsors of Rock Health Summit 2017 are from what industries	Information_Technology|Government|Charity|GovTech|CRM|Consulting|Enterprise_Software|Financial_Services|Software|Outsourcing|Business_Development|Business_Information_Systems|Health_Care|Construction|Biotechnology|Medical|Chemical|Non_Profit|Pharmaceutical|Education
the sponsors of WFFConnect Amsterdam One-Day are from what industries	Information_Technology|Professional_Services|Security|Intellectual_Property|Venture_Capital|Government|Big_Data|Advice|Consulting|Financial_Services|Legal|Small_and_Medium_Businesses|Management_Consulting|Outsourcing|Accounting|Business_Development|Information_Services|Stock_Exchanges|Banking|Service_Industry|Finance|Association|Non_Profit|Trading_Platform
the sponsors of The New and Improved Way of Investing in Startups. are from what industries	Funding_Platform|Crowdfunding|Finance|FinTech
the sponsors of Independent Games Festival 2016 are from what industries	News
the sponsors of AR & VR World 2018 are from what industries	Information_Technology|Software|Hardware|3D_Technology|Market_Research|Printing|Industrial|Virtual_Reality
the sponsors of Forbes Healthcare Summit 2016 are from what industries	Information_Technology|Electronics|Professional_Services|Wellness|Big_Data|Advice|Consulting|Financial_Services|Consumer_Electronics|Customer_Service|Legal|Health_Diagnostics|Social_Impact|Management_Consulting|Accounting|Insurance|B2B|Health_Care|Biotechnology|Medical|Communities|Non_Profit|Lighting
the sponsors of TechCrunch Barcelona Meetup PitchOff 2015 are from what industries	Android|Mobile|Ad_Network|Analytics|Publishing|Advertising|Virtualization|Emerging_Markets|Mobile_Advertising|Apps
the sponsors of Domino Data Science Popup San Francisco 2017 are from what industries	Web_Development|Information_Technology|Data_Visualization|Venture_Capital|Web_Design|Big_Data|Events|Software|Publishing|Collaboration|Artificial_Intelligence|Machine_Learning|EBooks|UX_Design|Coworking|Training|Communities|Data_Integration|Analytics|Product_Design|Education
the sponsors of AngelHack Austin 2016 are from what industries	Web_Development|Information_Technology|E-Commerce|Art|Web_Design|Enterprise_Software|Software|Cloud_Computing|Information_Services|Developer_APIs|Hardware|EdTech|Telecommunications|Mobile|IT_Management|Wireless|Data_Center|Delivery|Education|Network_Security|Retail|Crowdsourcing
the sponsors of EXEC 2017 are from what industries	Information_Technology|FinTech|Venture_Capital|Internet|Consulting|Enterprise_Software|Financial_Services|Software|Mobile_Payments|Payments|Infrastructure|Management_Consulting|Outsourcing|Business_Development|Accounting|Insurance|Banking|E-Commerce_Platforms|Telecommunications|Transaction_Processing|Mobile|Human_Resources|Finance|Retail
the sponsors of AdMonsters Publisher Forum 2016 are from what industries	Enterprise_Software|Analytics|Advertising|Internet|Video|Advertising_Platforms
the sponsors of 49th Millbrae Art & Wine Festival, The Last Blast of Summer are from what industries	Water_Purification|Smart_Home|Internet_of_Things|CleanTech
the sponsors of Growth Hacking Advanced Tactics: Hands-On Workshop San Francisco are from what industries	Web_Development|Information_Technology|Web_Hosting|Virtualization|Product_Design|UX_Design|Web_Design|Cloud_Computing|Education
the sponsors of Everywhere Else Tennessee are from what industries	SEO|Legal|Intellectual_Property|Social_Media|Semantic_Search|Web_Design|Transportation|Consulting
the sponsors of San Francisco Blockchain Week are from what industries	Application_Specific_Integrated_Circuit_(ASIC)|Electronics|Cloud_Data_Services|Financial_Services|Semiconductor|Computer|FinTech|Bitcoin|Blockchain|Infrastructure|Finance|Business_Development|Accounting|Manufacturing|Cloud_Computing|Cryptocurrency|Consulting
the sponsors of Citrix Synergy 2018 are from what industries	Information_Technology|Electronics|Security|FinTech|Virtualization|Internet|Developer_Platform|Mobile_Devices|Big_Data|CRM|Enterprise_Software|Software|Consumer_Electronics|Desktop_Apps|Commercial|Artificial_Intelligence|Virtual_Desktop|Cloud_Infrastructure|Cloud_Security|Cloud_Computing|Virtual_Reality|Information_Services|Biometrics|Cloud_Data_Services|Hardware|Health_Care|SaaS|Document_Management|IT_Infrastructure|Identity_Management|Training|Manufacturing|Cloud_Management|Cyber_Security|Mobile|Fraud_Detection|IT_Management|Data_Storage|Enterprise|Analytics|Wireless|Data_Center|Product_Design|Printing|Education|Network_Security|Communications_Infrastructure|GPU|Computer
the sponsors of European Innovation Day 2016 are from what industries	Life_Science|Information_Technology|Financial_Services|Corporate_Training|Social_Network|Social|Venture_Capital|Government|Finance|Angel_Investment|Innovation_Management|Non_Profit|Social_Media|Association|Business_Development|Education|Network_Hardware|Consulting
the sponsors of Igniter Annual Conference 2017 are from what industries	Search_Engine|Meeting_Software|Q&A|Professional_Networking|Event_Management|E-Commerce|Venture_Capital|Association|Web_Apps|Training|Communities|Incubators|Events|Sales_Automation
the sponsors of Brighter Together: 29th Annual Tree Lighting Celebration are from what industries	Health_Care|Non_Profit
the sponsors of ITU Gate Demo Day are from what industries	Universities|Architecture|Education
the sponsors of Consensus 2022 are from what industries	Information_Technology|Mining|Gift_Exchange|Private_Social_Networking|Compliance|Advice|CRM|Events|Enterprise_Software|Sustainability|Software|Outsourcing|Developer_Tools|Insurance|Marketing|Database|Information_Services|Linux|Commercial_Real_Estate|Mining_Technology|IT_Infrastructure|Peer_to_Peer|Manufacturing|Software_Engineering|Chemical|iOS|Consumer_Goods|Wireless|Real_Estate|Data_Center|Financial_Exchanges|News|Finance|Pharmaceutical|Precious_Metals|Trading_Platform|Retail|Computer|Credit_Cards|Security|Intellectual_Property|Messaging|Art|Developer_Platform|Robotics|Industrial|Legal_Tech|Cryptocurrency|Apps|Stock_Exchanges|Open_Source|Marketplace|Lending|Quality_Assurance|Risk_Management|E-Commerce_Platforms|Law_Enforcement|Public_Relations|Crowdfunding|Virtual_Currency|Social_Network|Enterprise_Resource_Planning_(ERP)|Education|Gift_Card|Web_Development|FinTech|Asset_Management|Government|Angel_Investment|Social_Media|Operating_Systems|Supply_Chain_Management|Life_Science|Debit_Cards|Consumer_Electronics|Bitcoin|Payments|Privacy|Biometrics|B2B|Banking|Business_Information_Systems|Construction|Service_Industry|Auctions|Transaction_Processing|Mobile|Enterprise|Analytics|Blockchain|Association|Non_Profit|Ethereum|Network_Security|Identity_Management|Aerospace|Professional_Services|Industrial_Engineering|Event_Management|Advertising|E-Commerce|Venture_Capital|Internet|Consulting|Financial_Services|Consumer_Lending|Digital_Media|Mobile_Payments|Legal|Infrastructure|Business_Development|Accounting|Search_Engine|Digital_Marketing|Health_Care|Loyalty_Programs|SaaS|Biotechnology|Telecommunications|Communities|Location_Based_Services|Cyber_Security|Document_Preparation|Journalism|Wealth_Management|Printing|Internet_of_Things
the sponsors of StrategyChat: Curating Unexpected Partnerships w/ GE & betaworks are from what industries	Commercial_Real_Estate|Coworking|Property_Development|Real_Estate
the sponsors of Festival da TransformaÃ§Ã£o 2018 are from what industries	Mobile_Apps|Event_Management|Ticketing|Event_Promotion|Events|Internet_of_Things
the sponsors of Ramp Up Tour 2019 - SÃ£o Paulo are from what industries	SMS|Information_Technology|Sales|Marketing_Automation|Event_Management|FinTech|Internet|Ticketing|Developer_Platform|CRM|Consulting|Enterprise_Software|Credit|Meeting_Software|Financial_Services|Software|Consumer_Lending|Consumer_Electronics|Recruiting|Collaboration|Personal_Finance|Small_and_Medium_Businesses|Developer_Tools|Skill_Assessment|Cloud_Computing|Information_Services|Developer_APIs|B2B|Banking|Business_Information_Systems|PaaS|Employment|SaaS|Telecommunications|VoIP|Training|Sales_Automation|Mobile|Human_Resources|Project_Management|Education|Network_Security|Staffing_Agency
the sponsors of Frontiers 2017 are from what industries	Android|Information_Technology|Ediscovery|Video_Conferencing|Unified_Communications|Professional_Services|Marketing_Automation|Sales|File_Sharing|FinTech|Data_Visualization|Messaging|Internet|Email|Developer_Platform|Big_Data|Management_Information_Systems|CRM|Enterprise_Software|Software|Customer_Service|Computer|Collaboration|Artificial_Intelligence|Small_and_Medium_Businesses|Developer_Tools|Flash_Storage|Private_Cloud|Cloud_Security|Machine_Learning|Cloud_Computing|Apps|Productivity_Tools|Developer_APIs|B2B|Cloud_Data_Services|Open_Source|PaaS|Professional_Networking|Web_Hosting|SaaS|Real_Time|Service_Industry|IT_Infrastructure|Direct_Sales|UX_Design|Business_Intelligence|Sales_Automation|Cyber_Security|Mobile|Technical_Support|Human_Resources|Data_Integration|Project_Management|Analytics|Product_Design|Identity_Management|Billing|Internet_of_Things
the sponsors of S4X20 ICS Security Conference 2020 are from what industries	Information_Technology|Electronics|Industrial_Automation|Security|Industrial_Engineering|Professional_Services|Asset_Management|Embedded_Systems|Oil_and_Gas|Virtualization|Internet|Civil_Engineering|Consulting|Enterprise_Software|Software|Energy_Management|Collaboration|Robotics|Industrial|Infrastructure|Outsourcing|Privacy|Artificial_Intelligence|Cloud_Security|Hardware|Construction|Manufacturing|Sales_Automation|Cyber_Security|Mobile|Technical_Support|Fraud_Detection|Energy|Analytics|Real_Estate|Renewable_Energy|Finance|Network_Security|Computer|Internet_of_Things
the sponsors of Traditional vs. Corporate VC: Which Is Better for Your Startup? are from what industries	Consulting
the sponsors of AtlasCamp 2016 are from what industries	Enterprise_Software|Mobile|Information_Technology|Project_Management|Business_Information_Systems|Software|Real_Time|SaaS|Internet|Developer_Tools|Software_Engineering|Apps
the sponsors of Mobile App Growth with Saama Capital and Rolocule Games are from what industries	Mobile|Mobile_Apps|iOS|Software|App_Marketing|Advertising|Communities|Apps
the sponsors of CHina CHat 2018 are from what industries	Information_Technology|Marketing_Automation|Advertising|E-Commerce|Messaging|Brand_Marketing|Big_Data|Universities|Enterprise_Software|Organic_Food|Software|Hospitality|Marketing|Apps|Loyalty_Programs|Food_and_Beverage|Higher_Education|Reputation|Analytics|Local|Education|Retail
the sponsors of Eureka Park CES 2017 are from what industries	Information_Technology|Chemical_Engineering|Semiconductor|FinTech|Venture_Capital|Government|Financial_Services|Robotics|Funding_Platform|Environmental_Engineering|Hedge_Funds|Biotechnology|EdTech|Manufacturing|Crowdfunding|Medical_Device|Nanotechnology|Wireless|Finance|Advanced_Materials|Internet_of_Things
