Venture Round - Appilog is led by investors from what countries	ISR
Debt Financing - Jana Small Finance Bank is led by investors from what countries	USA
Venture Round - Vidimax is led by investors from what countries	RUS
Seed Round - Nodalview is led by investors from what countries	BEL
Grant - Calyx is led by investors from what countries	USA
Grant - Renalert is led by investors from what countries	USA
Secondary Market - Unitel is led by investors from what countries	SGP
Seed Round - Fittr is led by investors from what countries	SGP
Series A - Scoota is led by investors from what countries	GBR
Private Equity Round - United Internet Ventures is led by investors from what countries	USA
Series A - Citibox is led by investors from what countries	ESP
Series A - Nansen is led by investors from what countries	USA
Series B - Next Insurance is led by investors from what countries	USA
Series A - IN8Bio is led by investors from what countries	USA
Pre Seed Round - Biomage is led by investors from what countries	USA
Seed Round - Authlete is led by investors from what countries	USA
Grant - PreVision is led by investors from what countries	USA
Seed Round - Reply.ai is led by investors from what countries	USA
Convertible Note - 3D Usher is led by investors from what countries	USA
Pre Seed Round - Legacy is led by investors from what countries	USA
Pre Seed Round - CodeStream is led by investors from what countries	USA
Seed Round - Klaus is led by investors from what countries	DEU
Pre Seed Round - Social Fiction is led by investors from what countries	USA
Grant - Crestone is led by investors from what countries	USA
Series C - Behalf is led by investors from what countries	ISR
Series D - Centerstone Software is led by investors from what countries	USA
Series A - Achievers is led by investors from what countries	CAN
Angel Round - SUGAR is led by investors from what countries	CHN
Grant - DEAF is led by investors from what countries	USA
Pre Seed Round - Formula Consulting is led by investors from what countries	CAN
Series A - Capella Space is led by investors from what countries	USA
Seed Round - Causal is led by investors from what countries	USA
Series A - Qmadou.com is led by investors from what countries	CHN
Series A - Booyah is led by investors from what countries	USA
Series C - Leia is led by investors from what countries	DEU
Series A - Domio is led by investors from what countries	USA
Series C - Zepz is led by investors from what countries	MUS
Venture Round - Dawaai is led by investors from what countries	USA
Debt Financing - Dashlane is led by investors from what countries	USA
Series B - Hongjing International Education is led by investors from what countries	CHN
Venture Round - OnePlace Capital is led by investors from what countries	GBR
Grant - Royal West of England Academy is led by investors from what countries	GBR
Post-IPO Secondary - Gokaldas Exports Ltd. is led by investors from what countries	IND
Debt Financing - DTiQ is led by investors from what countries	USA
Series A - Zhont is led by investors from what countries	CHN
Venture Round - Blu Wireless is led by investors from what countries	GBR
Seed Round - Citymart is led by investors from what countries	USA
Venture Round - QuVIS is led by investors from what countries	USA
Series A - Frnd is led by investors from what countries	KOR
Series B - Vyze is led by investors from what countries	USA
Series A - FiPath is led by investors from what countries	USA
Venture Round - BriefCam is led by investors from what countries	USA
Debt Financing - Lendify is led by investors from what countries	GBR
Series A - expressor software is led by investors from what countries	USA
Venture Round - nanoGriptech is led by investors from what countries	TWN
Series A - Verax Biomedical is led by investors from what countries	USA
Series A - Prevalent Networks is led by investors from what countries	USA
Grant - Symphony is led by investors from what countries	HKG
Series B - Pepperdata is led by investors from what countries	USA
Post-IPO Equity - Baofeng is led by investors from what countries	CHN
Private Equity Round - Eliza is led by investors from what countries	USA
Seed Round - Interpac is led by investors from what countries	GBR
Series B - Education.com is led by investors from what countries	USA
Seed Round - Shot Stats is led by investors from what countries	USA
Series A - Beem Energy is led by investors from what countries	FRA
Debt Financing - Hunt & Sons is led by investors from what countries	IND
Debt Financing - FlexiLoans is led by investors from what countries	USA
Series A - NeuMoDx Molecular is led by investors from what countries	USA
Series A - Addi is led by investors from what countries	USA
Seed Round - Gali Health is led by investors from what countries	USA
Series A - RubrYc Therapeutics is led by investors from what countries	USA
Venture Round - Chajjhed Foods is led by investors from what countries	IND
Venture Round - Yoshimura Food Holdings is led by investors from what countries	JPN
Series B - ZillionTV is led by investors from what countries	USA
Post-IPO Equity - Kraken Robotics is led by investors from what countries	CAN
Venture Round - Nutrebem is led by investors from what countries	BRA
Series D - Incorta is led by investors from what countries	USA
Series B - Syndio is led by investors from what countries	USA
Pre Seed Round - 3chron is led by investors from what countries	ISR
Venture Round - E-novate is led by investors from what countries	FRA
Series A - Qu He Cha is led by investors from what countries	CHN
Venture Round - The Predictive Index is led by investors from what countries	USA
Seed Round - UpCodes is led by investors from what countries	DEU
Seed Round - Sendjoy is led by investors from what countries	SGP
Seed Round - Youcal is led by investors from what countries	SGP
Venture Round - DuraFizz is led by investors from what countries	BHR
Series A - Peakstone is led by investors from what countries	SGP
Venture Round - Paintbox is led by investors from what countries	GBR
Series C - Outspark is led by investors from what countries	USA
Seed Round - Senuto is led by investors from what countries	POL
Series E - HotelTonight is led by investors from what countries	USA
Series B - Y Media is led by investors from what countries	USA
Series C - Misfit Wearables is led by investors from what countries	USA
Seed Round - Velox is led by investors from what countries	GBR
Pre Seed Round - EasyKrishi is led by investors from what countries	IND
Seed Round - Clearly is led by investors from what countries	USA
Series C - HZO is led by investors from what countries	USA
Series B - Harver is led by investors from what countries	USA
Series A - Shengxinbao is led by investors from what countries	CHN
Debt Financing - CG Pearce is led by investors from what countries	GBR
