Toni Collis is the organizer of events in which cities	Austin
Brian Frumberg is the organizer of events in which cities	New York
Fonda LaShay is the organizer of events in which cities	Oslo
Kathrine Mitchell is the organizer of events in which cities	New York
Ed Roman is the organizer of events in which cities	San Francisco
Dan Romescu is the organizer of events in which cities	Bucharest
Mada Seghete is the organizer of events in which cities	Pune|Palo Alto|San Francisco|Seattle|Reykjavík
Max Markovtsev is the organizer of events in which cities	Chicago
Eric Malis is the organizer of events in which cities	Menlo Park
Suhas Patel is the organizer of events in which cities	New Delhi
Walt Hubis is the organizer of events in which cities	Santa Clara
Shashank Ravi Agrawal is the organizer of events in which cities	Bhubaneswar
Adam Cragg is the organizer of events in which cities	New York
Shaima Ghafoor is the organizer of events in which cities	Al Ain
TECBE INC is the organizer of events in which cities	Coppell
Shakeel Shams is the organizer of events in which cities	Singapore
Meltem Demirors is the organizer of events in which cities	Boston
Brian Shoicket is the organizer of events in which cities	New York
Daniel Rezac is the organizer of events in which cities	Chicago
Ted Bahr is the organizer of events in which cities	Boston
Andrea Echstenkamper is the organizer of events in which cities	San Francisco
Marije Pierson is the organizer of events in which cities	Cape Town
Ajay Nolakha is the organizer of events in which cities	Bhilwara
David Conroy is the organizer of events in which cities	Chicago
Patrick J. Sweeney II is the organizer of events in which cities	Chamonix-mont-blanc
Davide Calì is the organizer of events in which cities	Singapore
Nicholas MacGowan von Holstein is the organizer of events in which cities	Berlin
Jun Hyuk Ahn is the organizer of events in which cities	Seoul
Ruth Uribes is the organizer of events in which cities	San Carlos|San Jose|Palo Alto|San Francisco|Los Angeles
Anubhav Routray is the organizer of events in which cities	Bhubaneswar
Jamie Driver is the organizer of events in which cities	New York|Playa Vista
Harsh Mariwala is the organizer of events in which cities	Jaipur
Jason Rowley is the organizer of events in which cities	Portland
Zac Staples is the organizer of events in which cities	Boston
Marco Rodzynek is the organizer of events in which cities	London
Orly Shani is the organizer of events in which cities	Tel Aviv
Frank Horch is the organizer of events in which cities	New York
Chantra Be is the organizer of events in which cities	Phnom Penh
Colleen Blake is the organizer of events in which cities	Boston
David Bisset is the organizer of events in which cities	Miami
David Xu is the organizer of events in which cities	Santa Clara
Satish Talim is the organizer of events in which cities	Kochi
Kim Hill is the organizer of events in which cities	Westminster
Julie Knight is the organizer of events in which cities	San Francisco
Lee Peglow is the organizer of events in which cities	Santa Monica
Mark Read is the organizer of events in which cities	Stellenbosch
Claudio Sanchez is the organizer of events in which cities	Punta Cana
Vlad Nabat is the organizer of events in which cities	New York
Manpreet Bagga is the organizer of events in which cities	Las Vegas
Alon Goren is the organizer of events in which cities	Santa Monica
Kara Swisher is the organizer of events in which cities	Half Moon Bay
Prasath Nadarajah is the organizer of events in which cities	Colombo
Maria Benjumea is the organizer of events in which cities	Madrid
Andrea Saltarello is the organizer of events in which cities	Milano
Enmanuel Toribio is the organizer of events in which cities	Punta Cana
Christian Jansen is the organizer of events in which cities	Oslo
Divya Yadav is the organizer of events in which cities	Bhubaneswar
Ljuba Daviè is the organizer of events in which cities	Torino
Blas Guzman is the organizer of events in which cities	San Juan
Ryan Colby is the organizer of events in which cities	San Francisco
Ruthi Koren is the organizer of events in which cities	Tel Aviv
Dustin D. Trammell is the organizer of events in which cities	Austin
Todd Maurer is the organizer of events in which cities	Santa Monica
Darshil Patel is the organizer of events in which cities	Santa Monica
Manuel Corpas is the organizer of events in which cities	Cambridge
Florian Cornu is the organizer of events in which cities	Makati
Danny Gamboa is the organizer of events in which cities	Los Altos
Ganeshwara Hananda is the organizer of events in which cities	London
Andrew Case is the organizer of events in which cities	New Orleans
Darren Marble is the organizer of events in which cities	Santa Monica
Daniil Danilov is the organizer of events in which cities	London
Alexander Norman is the organizer of events in which cities	Toronto
Chris Lloyd is the organizer of events in which cities	London
Jeroen Leenarts is the organizer of events in which cities	Amsterdam
Brian Mac Mahon is the organizer of events in which cities	Santa Monica
Elijah Kitaka is the organizer of events in which cities	Nairobi
Rohit Tigga is the organizer of events in which cities	Davis
Aleksandar Velkoski is the organizer of events in which cities	Chicago
Vlad Ciurca is the organizer of events in which cities	Cluj-napoca
Joshua Murdock is the organizer of events in which cities	Orlando
Nima Schei is the organizer of events in which cities	Santa Clara|Glasgow
Rick Tuttle is the organizer of events in which cities	Miami
Christophe Potron is the organizer of events in which cities	Lisboa
Dj Smith is the organizer of events in which cities	New York
Derek Williams is the organizer of events in which cities	Dubai
Prinda Wanakule is the organizer of events in which cities	San Jose
Katy Kappler is the organizer of events in which cities	Denver
Sean Adams is the organizer of events in which cities	San Carlos
Kaliya Hamlin is the organizer of events in which cities	Mountain View
Daniel Iser is the organizer of events in which cities	Jacksonville
Erez R. Mizrachi is the organizer of events in which cities	Tel Aviv-yafo|Tel Aviv
Marcel Salathé is the organizer of events in which cities	Ecublens
Jayson Kim is the organizer of events in which cities	New York
Conor McLaughlin is the organizer of events in which cities	Singapore
Georgia McCabe is the organizer of events in which cities	San Francisco
Tatiana Fedorova is the organizer of events in which cities	Mountain View
Michael Schofield is the organizer of events in which cities	Miami
Heath Roehr is the organizer of events in which cities	Lincoln
David Riano is the organizer of events in which cities	Poznan
Joscha Leeuw is the organizer of events in which cities	Bielefeld
