Ingo Ruebe is the sponsor of events in which cities	Athens
Stephen Day is the sponsor of events in which cities	Hyderabad
Sara Spangelo is the sponsor of events in which cities	San Francisco
Tanu Chellam is the sponsor of events in which cities	San Jose|Burlingame
Stephen Cavey is the sponsor of events in which cities	Singapore|San Francisco
Stephan Clambaneva is the sponsor of events in which cities	Troy
Michael Barbine is the sponsor of events in which cities	Las Vegas
Anastasia Dmitrienko is the sponsor of events in which cities	Marbella
Adam Stanley is the sponsor of events in which cities	New York
Mehrdad Piroozram is the sponsor of events in which cities	Munich
Edward Musinski is the sponsor of events in which cities	London
Alasdair Allan is the sponsor of events in which cities	Austin
Max Blumberg is the sponsor of events in which cities	London
Thomas Balkizas MSC, MEng, MIoD is the sponsor of events in which cities	Mountain View|Sofia|Munich|Dubai|Cambridge|Berlin|London
Luke Klima is the sponsor of events in which cities	Munich
Bijoy B K is the sponsor of events in which cities	Los Angeles
Secure Channels Inc. is the sponsor of events in which cities	Orlando
Bruce Bale is the sponsor of events in which cities	London
Kevin Davidson is the sponsor of events in which cities	Barcelona
Jayson Kim is the sponsor of events in which cities	Newport|Dana Point
John Bernard is the sponsor of events in which cities	Barcelona|Las Vegas
Anuj Sachdeva is the sponsor of events in which cities	Santa Clara
Elio Assuncao is the sponsor of events in which cities	Cardiff
Juan F. Ageitos is the sponsor of events in which cities	London|Dallas
Mark Bates is the sponsor of events in which cities	Austin
Matthias Ruhri is the sponsor of events in which cities	Maribor|Graz
Uma Raghavan is the sponsor of events in which cities	Washington
Cyril Lemaire is the sponsor of events in which cities	Durham
Ash Tapia is the sponsor of events in which cities	San Francisco
Fred Wilson is the sponsor of events in which cities	New York
Jugraj Singh is the sponsor of events in which cities	New York
Kyle Hanslovan is the sponsor of events in which cities	Dallas
Sharlyn Lauby is the sponsor of events in which cities	London
Szymon Klimczak is the sponsor of events in which cities	Tel Aviv-yafo
Sam Hartnell is the sponsor of events in which cities	Anaheim
Masaru Sakamoto is the sponsor of events in which cities	San Francisco
BRAEDEN LICHTI is the sponsor of events in which cities	Boston
Eric Garcetti is the sponsor of events in which cities	Los Angeles
Kendall Thornton is the sponsor of events in which cities	Dana Point|Orlando
Ryokichi Onishi is the sponsor of events in which cities	Stanford
Clay Wilkes is the sponsor of events in which cities	Las Vegas
Patricia Schwartz is the sponsor of events in which cities	Santa Barbara
Jesse Pärnänen is the sponsor of events in which cities	Helsinki|London
Chris Laudando is the sponsor of events in which cities	Salinas
Adrian Jones is the sponsor of events in which cities	Las Vegas
Peter Olausson is the sponsor of events in which cities	New York
Francesco Baschieri is the sponsor of events in which cities	Brooklyn
Greg Sterling is the sponsor of events in which cities	Los Angeles
Janel Garvin is the sponsor of events in which cities	San Mateo
Ciprian Melian is the sponsor of events in which cities	Los Angeles
Han Gerrits is the sponsor of events in which cities	Boston
Alexey Pankratov is the sponsor of events in which cities	Marbella
Jonn Kean is the sponsor of events in which cities	San Francisco
Emanuel Allely is the sponsor of events in which cities	Paris
Jun Hyuk Ahn is the sponsor of events in which cities	Seoul
Ivan Todorov is the sponsor of events in which cities	Bucharest
Toby Mather is the sponsor of events in which cities	London
Jan Bednar is the sponsor of events in which cities	Coral Gables
Stefan Dobrev is the sponsor of events in which cities	Genève
William Michael Cunningham is the sponsor of events in which cities	London|West Palm Beach
Jorge Salamero Sanz is the sponsor of events in which cities	Portland
Adrien Fonzé is the sponsor of events in which cities	Barcelona
Jamie Driver is the sponsor of events in which cities	Newport|Dana Point
Adam Kostyal is the sponsor of events in which cities	Barcelona
Jonathan Prosser is the sponsor of events in which cities	Sydney
Michael Reinartz is the sponsor of events in which cities	Munich
Marlon Fleck is the sponsor of events in which cities	Berlin
Heather Bowerman is the sponsor of events in which cities	San Francisco
Yanik Guillemette is the sponsor of events in which cities	Bali
Tim Dierckxsens is the sponsor of events in which cities	Berkeley
Mohith Agadi is the sponsor of events in which cities	New Delhi|Santa Clara
Indrek Vainu is the sponsor of events in which cities	Tallinn|Amsterdam
Joanne Wilson is the sponsor of events in which cities	New York
Amali de Alwis is the sponsor of events in which cities	Helsinki|Lisbon|London
Jeff Klaben is the sponsor of events in which cities	Menlo Park
Lucas Hendren is the sponsor of events in which cities	Nashville
Cammila Yochabell is the sponsor of events in which cities	Dublin
Tessa Kelly is the sponsor of events in which cities	Prague
Ashish Umre is the sponsor of events in which cities	London
Matt Baker is the sponsor of events in which cities	Durham
Stephan Baral is the sponsor of events in which cities	San Jose
Dirk Stoltenberg is the sponsor of events in which cities	London
Ben Fenster is the sponsor of events in which cities	Los Angeles
Andrew Lewman is the sponsor of events in which cities	San Francisco|Las Vegas
Sylvain Forté is the sponsor of events in which cities	London
Ada Plus is the sponsor of events in which cities	Torun
Lee Blankenship is the sponsor of events in which cities	Salt Lake City|Las Vegas
Isabella Schidrich is the sponsor of events in which cities	Barcelona
Sam Clifton is the sponsor of events in which cities	Helsinki
Ilya Sukhar is the sponsor of events in which cities	San Francisco
Tom Hulme is the sponsor of events in which cities	London
Nish Parikh is the sponsor of events in which cities	San Diego
Karnika Yashwant is the sponsor of events in which cities	Delhi|London
Senthil Padmanabhan is the sponsor of events in which cities	Orlando
Evgeny Kayumov is the sponsor of events in which cities	Marbella
Mark Galvin is the sponsor of events in which cities	London
Ryan Baxter is the sponsor of events in which cities	Austin
Alexandra Kulachikova is the sponsor of events in which cities	Berlin|Istanbul
Tiffany Madison is the sponsor of events in which cities	Miami Beach
Joe Daniels is the sponsor of events in which cities	Irvine
