Jen Quinlan is the exhibitor of events in which countries	USA
Charles Greene is the exhibitor of events in which countries	USA
Alister Toma is the exhibitor of events in which countries	USA
Daria Shevchenko is the exhibitor of events in which countries	UKR
Amit Sharma is the exhibitor of events in which countries	DEU
Marco Massara is the exhibitor of events in which countries	USA
Karsten Guenther is the exhibitor of events in which countries	DEU|FRA
Chris Thomas is the exhibitor of events in which countries	ISR
Alena Melnikova is the exhibitor of events in which countries	PRT
Filip Granek is the exhibitor of events in which countries	USA
Maged Gamani is the exhibitor of events in which countries	GBR
Andrea Andolfato is the exhibitor of events in which countries	GBR
Michael Tan is the exhibitor of events in which countries	USA
Lorenzo Lurati is the exhibitor of events in which countries	PRT
Isaac Leshinsky is the exhibitor of events in which countries	GBR
Aysem Zorlu is the exhibitor of events in which countries	GBR
Mark Galvin is the exhibitor of events in which countries	NLD|GBR
Joseph Armand is the exhibitor of events in which countries	ESP
Jawad Nasrullah is the exhibitor of events in which countries	USA
Fadi Abbas is the exhibitor of events in which countries	DEU|USA
Vasile Granaci is the exhibitor of events in which countries	USA|GBR
Felipe Mechailech is the exhibitor of events in which countries	USA
Jérémy Goillot is the exhibitor of events in which countries	PRT
Nils Ziehn is the exhibitor of events in which countries	IRL
Jeffrey Ulatan is the exhibitor of events in which countries	GBR
Janet Wu is the exhibitor of events in which countries	USA
Niklas Barkmeyer is the exhibitor of events in which countries	DEU
Brian Handrigan is the exhibitor of events in which countries	DEU|PRT|USA
Brandon Hesinger is the exhibitor of events in which countries	USA
Joei Chan is the exhibitor of events in which countries	DEU|USA|GBR
Andreas Rudyk is the exhibitor of events in which countries	USA
Jasper Ruban is the exhibitor of events in which countries	USA
Jonathan Slater is the exhibitor of events in which countries	FIN
Nadiya Sheckler is the exhibitor of events in which countries	USA
Faustino Castro is the exhibitor of events in which countries	PRT
Secure Channels Inc. is the exhibitor of events in which countries	USA
Sergey Musienko is the exhibitor of events in which countries	PRT|FIN
Ali Hamze is the exhibitor of events in which countries	USA
Heather Bowerman is the exhibitor of events in which countries	USA
Kerry Washington is the exhibitor of events in which countries	USA
Prashant Kumar is the exhibitor of events in which countries	AUS
Bobby King is the exhibitor of events in which countries	DEU|USA
Blyth van Dam is the exhibitor of events in which countries	USA
Pierre Rinaldi is the exhibitor of events in which countries	FRA|JPN
Gil Carmo is the exhibitor of events in which countries	PRT|HKG
Reed Scarfino is the exhibitor of events in which countries	USA
Andrew Huff is the exhibitor of events in which countries	DEU
Shamim Akhtar is the exhibitor of events in which countries	PRT
Guy Kaplinsky is the exhibitor of events in which countries	ISR|USA
Marco Barbato is the exhibitor of events in which countries	ESP|DEU
Clément Sauvage is the exhibitor of events in which countries	FRA|FIN
Anson Tou Liu is the exhibitor of events in which countries	MEX
Danielle Geva is the exhibitor of events in which countries	CAN
Tom Orzikowski is the exhibitor of events in which countries	USA
Roland Isaev is the exhibitor of events in which countries	USA|AUS
Al Serino is the exhibitor of events in which countries	USA
Carolyn April is the exhibitor of events in which countries	USA
Ahmadreza Rofougaran is the exhibitor of events in which countries	ESP|USA
Anastasia Dmitrienko is the exhibitor of events in which countries	ESP
Freddy Elturk is the exhibitor of events in which countries	ARE
Emre Savaş is the exhibitor of events in which countries	TUR|EST
Tolga Arican is the exhibitor of events in which countries	TUR
Emmanuele Spera is the exhibitor of events in which countries	DEU|USA|ITA|ARE
Sinan Odak is the exhibitor of events in which countries	DEU
Nick NM Yap is the exhibitor of events in which countries	ESP|USA|TWN|CHN
Cyntia King is the exhibitor of events in which countries	USA
King Li is the exhibitor of events in which countries	CAN
Kevin Wilson is the exhibitor of events in which countries	GBR
Luciano Bernal is the exhibitor of events in which countries	FIN
Dudi Berkowitz Chicago is the exhibitor of events in which countries	USA
Ciprian Melian is the exhibitor of events in which countries	FRA
Iana Mykhailenko is the exhibitor of events in which countries	DEU|USA
Francois Mathieu is the exhibitor of events in which countries	CAN|USA
Ricardo Uzcategui is the exhibitor of events in which countries	USA
Henrik Gebbing is the exhibitor of events in which countries	DEU
Suzanne Borders is the exhibitor of events in which countries	USA
Erik Backer is the exhibitor of events in which countries	USA
Charles Nick is the exhibitor of events in which countries	NLD|USA
Dario N. Evers is the exhibitor of events in which countries	DEU
Alex Gostomelsky is the exhibitor of events in which countries	USA
Vincent Uribe is the exhibitor of events in which countries	FIN
Frank Stoecker is the exhibitor of events in which countries	ESP
Kennedy Muteti is the exhibitor of events in which countries	USA
David Kahale is the exhibitor of events in which countries	AUS
Gavin Manerowski is the exhibitor of events in which countries	GBR
Dimitri Zlobin is the exhibitor of events in which countries	PRT|IRL|POL|MLT
Nicolas Chollet is the exhibitor of events in which countries	FRA|PRT
Maciej Stępień is the exhibitor of events in which countries	SGP
Daniel Mishin is the exhibitor of events in which countries	USA
Mark Zechiel is the exhibitor of events in which countries	GBR|AUT|DEU|SVN|RUS
Eliza Yingzi Du is the exhibitor of events in which countries	USA
Erkin Coban is the exhibitor of events in which countries	ESP|DEU
Prabakar Sundarrajan is the exhibitor of events in which countries	USA
Shilpa Sharma is the exhibitor of events in which countries	USA
Joel Serino is the exhibitor of events in which countries	USA
Gerhard Fettweis is the exhibitor of events in which countries	DEU
Anuj Sachdeva is the exhibitor of events in which countries	USA
Adrien Bouillot is the exhibitor of events in which countries	FRA|USA
Phillip LaBrasca is the exhibitor of events in which countries	PRT|USA
Oleksii Tronchuk is the exhibitor of events in which countries	ISR
