Ragnar Sass was the lead investor of funding rounds in which countries	EST
Brett Giroir was the lead investor of funding rounds in which countries	USA
Cassiano Machado Silva was the lead investor of funding rounds in which countries	BRA
Aristarichus Weru was the lead investor of funding rounds in which countries	KEN
Guy Haddleton was the lead investor of funding rounds in which countries	USA
Oliver Slipper was the lead investor of funding rounds in which countries	GBR
Jay Minkoff was the lead investor of funding rounds in which countries	USA
Zvi Limon was the lead investor of funding rounds in which countries	USA
Thomas Shannon was the lead investor of funding rounds in which countries	USA
Jim Mellon was the lead investor of funding rounds in which countries	USA
Kevin Ryan was the lead investor of funding rounds in which countries	USA
Neeraj Bhargava was the lead investor of funding rounds in which countries	USA
Venk Krishnan was the lead investor of funding rounds in which countries	IND
Henry Demone was the lead investor of funding rounds in which countries	CAN
Muhammad Fitno was the lead investor of funding rounds in which countries	IDN
Vijay Chhikara was the lead investor of funding rounds in which countries	IND
Keisuke Honda was the lead investor of funding rounds in which countries	JPN
Joanne Wilson was the lead investor of funding rounds in which countries	USA
Christopher Galvin was the lead investor of funding rounds in which countries	USA
Hamdi Osman was the lead investor of funding rounds in which countries	ARE
Pilar Nestar Garcia was the lead investor of funding rounds in which countries	ESP
Vinay Kumar Bansal was the lead investor of funding rounds in which countries	IND
José Maria Cechelero was the lead investor of funding rounds in which countries	BRA
Isaac Fokuo was the lead investor of funding rounds in which countries	RUS
Othman Laraki was the lead investor of funding rounds in which countries	USA
Calvin Ayre was the lead investor of funding rounds in which countries	ZAF
Anders Pettersson was the lead investor of funding rounds in which countries	SWE
Nico Wittenborn was the lead investor of funding rounds in which countries	FRA
Weili Dai was the lead investor of funding rounds in which countries	USA
Jorge Cuesta was the lead investor of funding rounds in which countries	USA
Biz Stone was the lead investor of funding rounds in which countries	GBR
Adrian Sedlin was the lead investor of funding rounds in which countries	USA
Yunus Becit was the lead investor of funding rounds in which countries	TUR
Ludolf Ebner was the lead investor of funding rounds in which countries	DEU
Martin Robinson was the lead investor of funding rounds in which countries	GBR
John Morgan was the lead investor of funding rounds in which countries	USA
Ajith Nair was the lead investor of funding rounds in which countries	IND
Pierre Lorinet was the lead investor of funding rounds in which countries	SGP
Rafael Ortiz was the lead investor of funding rounds in which countries	GBR
Sergey Schedrin was the lead investor of funding rounds in which countries	RUS
Ankit Nagori was the lead investor of funding rounds in which countries	IND
Sudhir Mehta was the lead investor of funding rounds in which countries	IND
Richard Ling was the lead investor of funding rounds in which countries	USA
Edvinas Cernevicius was the lead investor of funding rounds in which countries	EST
Ankit Gupta was the lead investor of funding rounds in which countries	IND
Cosmas Wong was the lead investor of funding rounds in which countries	USA
Nadir Godrej was the lead investor of funding rounds in which countries	IND
Kristjan Raude was the lead investor of funding rounds in which countries	EST
Andrew Barclay was the lead investor of funding rounds in which countries	GBR
Sumon Sadhu was the lead investor of funding rounds in which countries	USA
Marcelo Nobrega was the lead investor of funding rounds in which countries	BRA
Fred Destin was the lead investor of funding rounds in which countries	CAN
Liam Casey was the lead investor of funding rounds in which countries	IRL
Lori Greiner was the lead investor of funding rounds in which countries	USA
Sean Mulryan was the lead investor of funding rounds in which countries	VNM
Karl Magnus Troedsson was the lead investor of funding rounds in which countries	SWE
Lee Fixel was the lead investor of funding rounds in which countries	USA
Caro Krissman was the lead investor of funding rounds in which countries	USA
Omar Ayesh was the lead investor of funding rounds in which countries	IRL
Gilad Haim was the lead investor of funding rounds in which countries	IND
Adam Tabriz was the lead investor of funding rounds in which countries	USA
Alexander Alten was the lead investor of funding rounds in which countries	DEU
Nick Grewal was the lead investor of funding rounds in which countries	USA
Lee Arnold was the lead investor of funding rounds in which countries	USA
Peter Schatzberg was the lead investor of funding rounds in which countries	ARE
William J. Morris was the lead investor of funding rounds in which countries	USA
Hironao Kunimitsu was the lead investor of funding rounds in which countries	JPN
Eugene Wong was the lead investor of funding rounds in which countries	SGP
Ramon Dalmases was the lead investor of funding rounds in which countries	ESP
Matthew Palevsky was the lead investor of funding rounds in which countries	USA
Jim Eberlin was the lead investor of funding rounds in which countries	USA
Cassio Jose Krupinsk was the lead investor of funding rounds in which countries	BRA
Trip Hawkins was the lead investor of funding rounds in which countries	USA
Dan Gilbert was the lead investor of funding rounds in which countries	USA
Deepak Madnani was the lead investor of funding rounds in which countries	CHE
Werner Hoffmann was the lead investor of funding rounds in which countries	CHE
Jerry Jones was the lead investor of funding rounds in which countries	USA
Aziz Tarak was the lead investor of funding rounds in which countries	BGD
shaween chan was the lead investor of funding rounds in which countries	SGP|CHE|USA
Max Pauwels was the lead investor of funding rounds in which countries	USA
Graham McNeil-Watson was the lead investor of funding rounds in which countries	GBR
Marc Benioff was the lead investor of funding rounds in which countries	USA
Klaus Hommels was the lead investor of funding rounds in which countries	DEU
Nina Alag Suri was the lead investor of funding rounds in which countries	SGP
Jovan Hutton Pulitzer was the lead investor of funding rounds in which countries	USA
Pascal Levy-Garboua was the lead investor of funding rounds in which countries	MAR
Michael Fainshtein was the lead investor of funding rounds in which countries	USA
Kittu Kolluri was the lead investor of funding rounds in which countries	USA
Heather Reisman was the lead investor of funding rounds in which countries	CAN
Brett Dawson was the lead investor of funding rounds in which countries	AUS
Daniel Perez was the lead investor of funding rounds in which countries	USA
Moray Keith was the lead investor of funding rounds in which countries	CAN
Michael Benabou was the lead investor of funding rounds in which countries	FRA
Josh James was the lead investor of funding rounds in which countries	USA
Fredrik Österberg was the lead investor of funding rounds in which countries	SWE
Mark Bivens was the lead investor of funding rounds in which countries	FRA
Jorg Mohaupt was the lead investor of funding rounds in which countries	USA
Jude Gomila was the lead investor of funding rounds in which countries	USA
Ayataro Nakagawa was the lead investor of funding rounds in which countries	JPN
Priyanka Madnani was the lead investor of funding rounds in which countries	IND
