the owner of Versant Vantage II is from what countries	USA
the owner of Ridge Road I is from what countries	USA
the owner of TIDE Africa Fund is from what countries	GBR
the owner of Spire Capital Partners III, LP is from what countries	USA
the owner of Eudemian Ventures Fund I, LP is from what countries	USA
the owner of Patient Capital Collaborative Fund I is from what countries	USA
the owner of Cigna Ventures I is from what countries	USA
the owner of SixThirty 2.0 is from what countries	USA
the owner of AlphaX Partners Fund I is from what countries	CHN
the owner of Saints Capital I is from what countries	USA
the owner of GoldenTree Asset Management LLC Credit Hedge Fund I is from what countries	USA
the owner of Fund I is from what countries	CHN
the owner of State of Mind Ventures Fund I is from what countries	ISR
the owner of Clearlake Capital Partners III, L.P. is from what countries	USA
the owner of Hardcore Technology Investment Fund is from what countries	HKG
the owner of Stony Lonesome Capital III LP is from what countries	USA
the owner of Accel India V Fund is from what countries	USA
the owner of Gaingels Delix Therapeutics is from what countries	USA
the owner of Spike Ventures Fund 2 is from what countries	USA
the owner of Equity Fund is from what countries	USA
the owner of Hill Path Capital Partners is from what countries	USA
the owner of Ironspring Venture Fund I is from what countries	USA
the owner of SV Angel II is from what countries	USA
the owner of Littlejohn Fund V, L.P. is from what countries	USA
the owner of True Green Capital Fund III is from what countries	USA
the owner of ComfortDelGro Capital Partners I is from what countries	SGP
the owner of OlympusGrowth Fund VI is from what countries	USA
the owner of RWI Group IV L.P is from what countries	USA
the owner of Shore Capital Food & Beverage Partners Fund I is from what countries	USA
the owner of MSDAVENIR is from what countries	USA
the owner of CCVC-KAKAO Jeju Creative Economy Innovative Fund is from what countries	KOR
the owner of BVP Century II is from what countries	USA
the owner of Spike Ventures Fund 3 is from what countries	USA
the owner of 33entrepreneurs Invest is from what countries	FRA
the owner of Monterro 2 is from what countries	SWE
the owner of DFJ Growth IV is from what countries	USA
the owner of Mercato Partners Growth II is from what countries	USA
the owner of Cielo Masterson I is from what countries	USA
the owner of Birch Hill Equity Partners V LP is from what countries	CAN
the owner of Sofinnova Capital VI is from what countries	FRA
the owner of Lion Capital Fund IV is from what countries	GBR
the owner of Trident Capital Fund VII is from what countries	USA
the owner of CTRL USA HealthCare Fund is from what countries	USA
the owner of Green Acre Capital Fund II is from what countries	CAN
the owner of Sofinnova Venture Partners VIII, L.P. is from what countries	USA
the owner of Combine Fund I,L.P. is from what countries	USA
the owner of Masthead Venture Partners Capital is from what countries	USA
the owner of Chrysalix Energy III US Limited Partnership is from what countries	CAN
the owner of Prime Movers Lab Fund I is from what countries	USA
the owner of ElmTree Net Lease Fund II is from what countries	USA
the owner of DB Private Equity Secondary Opportunities Fund III LP is from what countries	DEU
the owner of Draper B1 Fund III is from what countries	ESP
the owner of Vamana Real Estate Equities I LP is from what countries	USA
the owner of Nissay Capital Fund VII is from what countries	JPN
the owner of Aegis Special Situations QP Fund, LLC- Series Aerospace I is from what countries	USA
the owner of DEERFIELD HEALTHCARE INNOVATIONS FUND is from what countries	USA
the owner of CAI Capital Partners Fund VI is from what countries	CAN
the owner of The Board and Downing is from what countries	GBR
the owner of Bain Capital Partnership Strategies Emerging Markets Fund is from what countries	USA
the owner of PHPF I is from what countries	USA
the owner of Fifth Wall Ventures Retail Fund is from what countries	USA
the owner of Crisis Fund is from what countries	HUN
the owner of SanDisk Capital Fund is from what countries	USA
the owner of Inveready Venture Finance III is from what countries	ESP
the owner of Auto Industry Fund is from what countries	CHN
the owner of Savory Fund I is from what countries	USA
the owner of FountainVest China Capital Partners Fund III is from what countries	HKG
the owner of Riverside Micro-Cap Fund I is from what countries	USA
the owner of Alliance Technology Ventures III is from what countries	USA
the owner of Alta Partners NextGen Fund I is from what countries	USA
the owner of Austin Ventures III LP is from what countries	USA
the owner of Creandum V is from what countries	SWE
the owner of DFJ Gotham Venture Fund II is from what countries	USA
the owner of JumpFund II is from what countries	USA
the owner of Secondaries & Liquidity Solutions Fund is from what countries	USA
the owner of Clairvest Equity Partners V is from what countries	CAN
the owner of 3one4 Capital Rising I is from what countries	IND
the owner of MAVCAP I is from what countries	MYS
the owner of India Realty Excellence Fund V (IREF V) is from what countries	IND
the owner of International Partnership Fund is from what countries	SGP
the owner of VIA Energy III is from what countries	USA
the owner of Closed Loop Venture Fund II is from what countries	USA
the owner of IKEA GreenTech fund is from what countries	SWE
the owner of Adobe Capital Partners Seed Fund is from what countries	USA
the owner of Larimer County Energy Fund LP is from what countries	USA
the owner of AngelPad Beta is from what countries	USA
the owner of Juggernaut Capital Partners IV-A is from what countries	USA
the owner of UBV Fund-I is from what countries	JPN
the owner of Essex Specialty Funds LP is from what countries	USA
the owner of Chalkline Partners is from what countries	USA
the owner of Sosei RMF1 is from what countries	JPN
the owner of IPR.VC Fund II is from what countries	FIN
the owner of Fireman Capital Partners III is from what countries	USA
the owner of Fund IV is from what countries	USA
the owner of Aegis Special Situations Fund LLC - Series Medtech VI is from what countries	USA
