Eric Archambeau invested in which seed funding rounds	Seed_Round_-_SignalRank_Corporation@0d50f
Yasmin Shahin Shaikh invested in which pre_seed funding rounds	Pre_Seed_Round_-_YAS@6fa80
Dan Scheinman invested in which series_c funding rounds	Series_C_-_CyCognito@d5754
Cliff Holekamp invested in which series_b funding rounds	Series_B_-_LockerDome@8fdf1|Series_B_-_Clever_Real_Estate@c72ab
Lou Kerner invested in which undisclosed funding rounds	Funding_Round_-_Polar@ef2ed
Steen Ulf Jensen invested in which pre_seed funding rounds	Pre_Seed_Round_-_Cavea@fcf78
Betsalel Elfassy invested in which undisclosed funding rounds	Funding_Round_-_Brands_Capital@e2419
Jay Minkoff invested in which seed funding rounds	Seed_Round_-_Houwzer@abc4e|Seed_Round_-_Houwzer@328cc
Rohit Dalvi invested in which private_equity funding rounds	Private_Equity_Round_-_Infovys@46acf
Udo Schloemer invested in which seed funding rounds	Seed_Round_-_Sdui@7346f
Edward Lando invested in which seed funding rounds	Seed_Round_-_Pronto@24d3e
Mika Salmi invested in which series_a funding rounds	Series_A_-_Inkd.com@f8a89
Mark Bivens invested in which convertible_note funding rounds	Convertible_Note_-_Keyyo@18219
Elad Gil invested in which seed funding rounds	Seed_Round_-_AgentSync@78b5b
Damon Carr invested in which seed funding rounds	Seed_Round_-_Data_Lake_Shore@5389c
Tom Williams invested in which seed funding rounds	Seed_Round_-_Huckleberry_Labs@9a9b0
Saniya Shaikha invested in which pre_seed funding rounds	Pre_Seed_Round_-_Birbaboti@99cf6
NON-fungible Chan invested in which pre_seed funding rounds	Pre_Seed_Round_-_Bling@1acbf
Dmitry Shapiro invested in which series_a funding rounds	Series_A_-_iList@7ad22
Chris Kelly invested in which series_a funding rounds	Series_A_-_Streamweaver@20b33
Kenzi Wang invested in which undisclosed funding rounds	Funding_Round_-_Current_Mobile@2e245
Vinay Iyengar invested in which pre_seed funding rounds	Pre_Seed_Round_-_Wander@1569d
John Textor invested in which series_b funding rounds	Series_B_-_JesterDigital@e7049
Mohsen Moazami invested in which seed funding rounds	Seed_Round_-_Peek@9f15a
Jenny Lefcourt invested in which series_a funding rounds	Series_A_-_Daily.co@f2998
Abdul Sh invested in which pre_seed funding rounds	Pre_Seed_Round_-_Graphenizer@ac63e
Sophia Collier invested in which seed funding rounds	Seed_Round_-_Pronto@24d3e
Marek Olszewski invested in which pre_seed funding rounds	Pre_Seed_Round_-_Payourse@3c05f
Scott Belsky invested in which series_c funding rounds	Series_C_-_Uber@250e9
Jay Minkoff invested in which series_a funding rounds	Series_A_-_Houwzer@e36d9
Alexander Edward Chesterman invested in which seed funding rounds	Seed_Round_-_Uniplaces@b3ae9
Lawrence Lenihan invested in which seed funding rounds	Seed_Round_-_Resonance_Companies,_Inc.@9f1db
Bav Kong invested in which private_equity funding rounds	Private_Equity_Round_-_Music_Lover@5b807
Sushil Sharma invested in which seed funding rounds	Seed_Round_-_Marwari_Catalysts@3fbf0
Sunder Nookala invested in which pre_seed funding rounds	Pre_Seed_Round_-_Big.Jobs@f96e7
Jeffrey Cherry invested in which pre_seed funding rounds	Pre_Seed_Round_-_Bodha_Inc@45d6d
Samuel Kwame Boadu invested in which seed funding rounds	Seed_Round_-_SamBoad_Travel_and_Educational_Consult@e7d16|Seed_Round_-_SamBoad_Micro-Credit_Services@3fdfc
Ali Rasoul invested in which angel funding rounds	Angel_Round_-_Ali_Rasoul_LTD@eaf5c
Jenny Rooke invested in which seed funding rounds	Seed_Round_-_Zymergen@f8e82|Seed_Round_-_Zephyrus_Biosciences@66943
George Coehlo invested in which seed funding rounds	Seed_Round_-_SignalRank_Corporation@0d50f
Thu Nguyen Thi invested in which seed funding rounds	Seed_Round_-_HTK_SHIPPING_AND_IMPORT_EXPORT_CO.,LTD@63c0e
Ariel Luedi invested in which angel funding rounds	Angel_Round_-_Scandit@b0acf
Haresh Chawla invested in which seed funding rounds	Seed_Round_-_Rocketbox@58a3f
Lip-Bu Tan invested in which seed funding rounds	Seed_Round_-_SignalRank_Corporation@0d50f
Scott Banister invested in which series_a funding rounds	Series_A_-_Dyspatch@6cef3
Josh Mailman invested in which series_a funding rounds	Series_A_-_Grove_Collaborative@81657
Ira Lubert invested in which series_a funding rounds	Series_A_-_Houwzer@e36d9
Michael Halbherr invested in which seed funding rounds	Seed_Round_-_DigiSure@b0706
Mark Cuban invested in which series_a funding rounds	Series_A_-_BlueCava@85528
Niklas Ostberg invested in which series_b funding rounds	Series_B_-_Fresha@bacc5
Amrut Kamani invested in which pre_seed funding rounds	Pre_Seed_Round_-_Teksun_Inc@b3fb7
William Kirby invested in which series_a funding rounds	Series_A_-_Internet_Distribution_Systems_(IDS_LLC.)@eec5e
Jerry Murdock invested in which convertible_note funding rounds	Convertible_Note_-_PayRange@90c09
Michael Kleindl invested in which pre_seed funding rounds	Pre_Seed_Round_-_Mediasmart@e88cd
Udo Schloemer invested in which series_a funding rounds	Series_A_-_Sdui@4e289
Robin Vauvelle invested in which private_equity funding rounds	Private_Equity_Round_-_Online_Shop@b0b3c
Elena Perepelychnaya invested in which seed funding rounds	Seed_Round_-_Inserviss_Marketplace@c8ea3
Matt Ocko invested in which seed funding rounds	Seed_Round_-_Set_Labs@ba81d
Romero Rodrigues invested in which undisclosed funding rounds	Funding_Round_-_Buscap√©@d9940
Roy Vann invested in which seed funding rounds	Seed_Round_-_Zenu_App_LLC@b1209
Fabio Rosati invested in which seed funding rounds	Seed_Round_-_DigiSure@b0706
Amit Patni invested in which seed funding rounds	Seed_Round_-_Wellness_Forever_Medicare@2391e
Abishek Sithampalam invested in which seed funding rounds	Seed_Round_-_findmyfare.com@b0fb2
Mike Chalfen invested in which seed funding rounds	Seed_Round_-_AtomicJar@9f440
Brian Ross invested in which private_equity funding rounds	Private_Equity_Round_-_WTI_(Western_Telematic_Inc)@7d593
Daniel O'Leary invested in which debt_financing funding rounds	Debt_Financing_-_Product_Revolution_Consulting@e8b45
Jessie Lam invested in which seed funding rounds	Seed_Round_-_Partsimony@0c093
Franciscus Zheng invested in which pre_seed funding rounds	Pre_Seed_Round_-_PopIt_Snack@50b98
Murat Abdrakhmanov invested in which seed funding rounds	Seed_Round_-_Influ2@73163
Jim Eberlin invested in which seed funding rounds	Seed_Round_-_Juristat@d7a63
Kaj Hed invested in which seed funding rounds	Seed_Round_-_Kiosked@c1508
Pavel Glushenkov invested in which seed funding rounds	Seed_Round_-_CrowdSystems@8f395|Seed_Round_-_Level_Travel@ea2cd
Taavet Hinrikus invested in which pre_seed funding rounds	Pre_Seed_Round_-_Pactum@f3e1d
Janke Dittmer invested in which series_c funding rounds	Series_C_-_Sapiens_Steering_Brain_Stimulation@07c7d
Arul Murugan invested in which pre_seed funding rounds	Pre_Seed_Round_-_Musicasa@9faf8
Sagar Ratilal Bavarva invested in which pre_seed funding rounds	Pre_Seed_Round_-_HydraX_Incorporation@396f8
Cassio Jose Krupinsk invested in which pre_seed funding rounds	Pre_Seed_Round_-_OXIBIZ@15239
Amin Chaar invested in which pre_seed funding rounds	Pre_Seed_Round_-_ecadema_-_Online_Learning@d02fc
Ido Leffler invested in which seed funding rounds	Seed_Round_-_Omni@4b1ba
Michael Altrichter invested in which pre_seed funding rounds	Pre_Seed_Round_-_App_Radar@fdc1c
Kevin Wall invested in which series_a funding rounds	Series_A_-_Kiosked@0becd
Jovan Hutton Pulitzer invested in which seed funding rounds	Seed_Round_-_Infotainment_Telepictures@4e763
Faisal Yasin invested in which pre_seed funding rounds	Pre_Seed_Round_-_1ID@ef23d
Patrick Zeeuw invested in which pre_seed funding rounds	Pre_Seed_Round_-_HIGH_PROFILE_CLUB@4a728
Jason Calacanis invested in which series_b funding rounds	Series_B_-_Cozy@e3982|Series_B_-_Chartbeat@1cc71|Series_B_-_ToutApp@972b6
Brian Craig invested in which seed funding rounds	Seed_Round_-_Nanoprecise_Sci_Corp@37f53
Todd Corenson invested in which convertible_note funding rounds	Convertible_Note_-_HelixNano@8ba97
Ishara Yusdian invested in which seed funding rounds	Seed_Round_-_Foom@cf1f1
Steve Bornstein invested in which seed funding rounds	Seed_Round_-_Skyfish@117e7
Douglas Teitelbaum invested in which private_equity funding rounds	Private_Equity_Round_-_NJOY@b51fd
Shane Donald invested in which pre_seed funding rounds	Pre_Seed_Round_-_Frontline_Investments_India@a5afe
Julie Meyer invested in which seed funding rounds	Seed_Round_-_Lime&Tonic@29c78
Larisa Serova invested in which seed funding rounds	Seed_Round_-_Befundo.com@b76a9
Dennis Weidner invested in which pre_seed funding rounds	Pre_Seed_Round_-_ePilot_Mobility@b848e
James Bilefield invested in which series_a funding rounds	Series_A_-_Polar@e62e0
John Curtis invested in which seed funding rounds	Seed_Round_-_Britcan_Media_Limited@13c58
Alejandro Revecco invested in which pre_seed funding rounds	Pre_Seed_Round_-_UHOMIE@aec06
Kai Hansen invested in which pre_seed funding rounds	Pre_Seed_Round_-_realxdata@3e043
Tomer Tagrin invested in which series_b funding rounds	Series_B_-_Anyword@5bda1
Trevor Sumner invested in which seed funding rounds	Seed_Round_-_Myro@c47bd
