list the people from USA who are lead investors in Series B - Next Step Living	John_McQuillan@6fa43
list the people from USA who are lead investors in Angel Round - DefenseStorm	Jeffrey_Lunsford@ad362
list the people from USA who are lead investors in Private Equity Round - Lowden Street Properties	Matt_Bean@9e3d5
list the people from USA who are lead investors in Series A - CallRail	Wain_Kellum@0fedf
list the people from USA who are lead investors in Pre Seed Round - Langaware	Georgios_Papadopoulos@eacfa
list the people from USA who are lead investors in Seed Round - Burns & Levinson	Josef_Volman@e757d
list the people from AUS who are lead investors in Seed Round - Spaceship	Mike_Cannon-Brookes@245be
list the people from FIN who are lead investors in Seed Round - WATTS BATTERY	Pekka_Viljakainen@759f7
list the people from CHE who are lead investors in Seed Round - Bodeboca	Michael_Kleindl@9fccd
list the people from IND who are lead investors in Angel Round - CreditVidya	Siddharth_Parekh@ce0ae
list the people from USA who are lead investors in Seed Round - SOCi	Peter_Fisher@bdcd8
list the people from GBR who are lead investors in Angel Round - Switchd	Doug_Monro@7e928
list the people from NLD who are lead investors in Seed Round - Ozarka	Matthew_Papakipos@25c35
list the people from USA who are lead investors in Pre Seed Round - WeStrive	Cory_McKane@4ff47
list the people from USA who are lead investors in Seed Round - MarkITx	Jack_Keenan@2d6ba
list the people from USA who are lead investors in Series A - DIMENSIONALMECHANICS	Kent_L._Johnson@89b1b
list the people from USA who are lead investors in Pre Seed Round - Relive	José_Costa_Rodrigues@04212
list the people from AUS who are lead investors in Grant - Helpmum	Alex_Waislitz@ca16e
list the people from DEU who are lead investors in Angel Round - Forexfix	Ludolf_Ebner@790b0
list the people from AUS who are lead investors in Pre Seed Round - nyfty.ai	Andrew_Larsen@4995b
list the people from HKG who are lead investors in Seed Round - Employee Wow	Sean_Tomlinson@e5e45
list the people from IND who are lead investors in Seed Round - Shenzhen Blog	Mekala_VIjayakumar@86686
list the people from HTI who are lead investors in Pre Seed Round - HaitiPay S.A.	Pascale_Elie@c291e
list the people from USA who are lead investors in Seed Round - RateMyProfessors.com	Patrick_Nagle@96ca1
list the people from FRA who are lead investors in Seed Round - Symaps.io	Jean-Paul_Guisset@7d969
list the people from USA who are lead investors in Seed Round - O4S	Amit_Singhal@cc86b
list the people from USA who are lead investors in Venture Round - TurboTenant	Kirk_Holland@b345e
list the people from USA who are lead investors in Equity Crowdfunding - Paradromics	Court_Westcott@deeda
list the people from SGP who are lead investors in Seed Round - K Hotel	Noel_Neo@1723b
list the people from CAN who are lead investors in Seed Round - Players' Lounge	Aubrey_Graham_(Drake)@d302d
list the people from USA who are lead investors in Series B - QualMetrix	Terence_M._Breslin@9c5fe
list the people from USA who are lead investors in Series A - buuteeq	Mike_Galgon@d7766
list the people from FIN who are lead investors in Seed Round - Kiosked	Kaj_Hed@a9efb
list the people from AUT who are lead investors in Angel Round - Anyline	"Johann_""Hansi""_Hansmann@32753"
list the people from IND who are lead investors in Pre Seed Round - SportiWe	Santhosh_Gowda@d5761
list the people from GBR who are lead investors in Seed Round - KodyPay	Yoyo_Chang@ce8d3
list the people from USA who are lead investors in Venture Round - BIG Labs	Jyoti_Bansal@ffeb6
list the people from USA who are lead investors in Pre Seed Round - Dropshyp	Arnold_Schwarzenegger@11420
list the people from USA who are lead investors in Series A - mophie	Carmelo_Anthony@606bd
list the people from USA who are lead investors in Seed Round - PrōForma Technologies	Gena_Vazquez@e0cf9
list the people from IND who are lead investors in Angel Round - The Indus Valley	Chandu_Nair@0a21c
list the people from USA who are lead investors in Series B - COLLABTRIBE	Hardik_Zaveri@2dcff
list the people from CHE who are lead investors in Series D - InSphero	Jürg_Gysi@62592
list the people from KOR who are lead investors in Seed Round - Wider Planet	Edward_Kyosik_Koo@55085
list the people from USA who are lead investors in Seed Round - Riverside.fm	Oren_Zeev@14231
list the people from USA who are lead investors in Pre Seed Round - Nemo	Shaun_Cooley@69af8
list the people from NLD who are lead investors in Seed Round - bunq	Ali_Niknam@ece01
list the people from DNK who are lead investors in Pre Seed Round - HeyDesk ApS	Marcel_Fuursted@42316
list the people from ARE who are lead investors in Pre Seed Round - Bringoo	Hasib_Khan@ca74e
list the people from IND who are lead investors in Seed Round - ImmunifyMe Healthcare Technologies Pvt Ltd	Adar_C._Poonawalla@1c8cf
list the people from MEX who are lead investors in Pre Seed Round - Interacpedia	Marco_Casarin@d6a50
list the people from USA who are lead investors in Series A - eFounders	Oleg_Tscheltzoff@ec0a2
list the people from TAN who are lead investors in Pre Seed Round - Octofi Limited	Elizabeth_Williams@8e577
list the people from CHE who are lead investors in Pre Seed Round - SWISS Gate AG	Ralph_Gygax@71a7e
list the people from UKR who are lead investors in Seed Round - Farmax	Ivan_Chebotaiev@59247
list the people from GBR who are lead investors in Seed Round - James	Gaël_de_Boissard@14af4
list the people from JPN who are lead investors in Venture Round - SportsField	Shinozaki_Katsushi@c8b7e
list the people from CAN who are lead investors in Series B - Neuranet	Paul_Vincent@24608
list the people from JPN who are lead investors in Venture Round - Eltes	Shuichi_Takenaga@58a3d
list the people from SGP who are lead investors in Angel Round - Abillion	Vikas_Garg@06d8b
list the people from USA who are lead investors in Seed Round - Quartic.ai	Michael_Marks@ccfdb
list the people from USA who are lead investors in Angel Round - Roll	Dan_Beldy@ad689
list the people from CAN who are lead investors in Series A - Coveo	Louis_Tetu@2b3fc
list the people from USA who are lead investors in Seed Round - Stronghold	David_Samuel@96670
list the people from RUS who are lead investors in Series A - USDX Wallet	Andrey_Peshkov@d5370
list the people from USA who are lead investors in Convertible Note - ONEDOME	Josh_Hannah@1d94b
list the people from DNK who are lead investors in Pre Seed Round - ithought	Casper_Spanggaard@a4a80
list the people from IND who are lead investors in Private Equity Round - Infovys	Rohit_Dalvi@18a6c
list the people from POL who are lead investors in Pre Seed Round - Onteon	Krzysztof_Polak@3a6db
list the people from USA who are lead investors in Seed Round - Picks & Shovels	Tyler_Willis@4950d
list the people from HKG who are lead investors in Seed Round - teaglo	Shawn_Sea@065cc
list the people from USA who are lead investors in Angel Round - reAlpha	Giri_Devanur@6437e
list the people from GBR who are lead investors in Seed Round - BKD	Peter_Jones@ca550
list the people from GBR who are lead investors in Series A - Skyroot Aerospace	Mahesh_Kolli@2627b
list the people from USA who are lead investors in Seed Round - House Deals	Jonathan_Marsh@d469a
list the people from USA who are lead investors in Seed Round - Grovara	David_Pottruck@91803
list the people from DNK who are lead investors in Venture Round - Conferize	Allan_Søgaard_Larsen@76d43
list the people from USA who are lead investors in Pre Seed Round - ClosedWon	Jason_Calacanis@21433
list the people from CAN who are lead investors in Angel Round - Athennian	James_Lochrie@2d0eb
list the people from USA who are lead investors in Angel Round - XIFAQ Consulting	Affaque_Ahmed@0d94e
list the people from SWE who are lead investors in Venture Round - Caliroots	Cristina_Stenbeck@3fae8
list the people from USA who are lead investors in Series A - Wunderkind (formerly BounceX)	Justin_Yoshimura@7a214
list the people from ESP who are lead investors in Series A - Jobandtalent	Pelayo_Cortina_Koplowitz@896ab
list the people from USA who are lead investors in Seed Round - HIAGO Inc.	Mircea_Voskerician@e78f8
list the people from USA who are lead investors in Seed Round - CareMonkey	Peter_Bencivenga@673ee
list the people from IND who are lead investors in Seed Round - Indie Apps	Sagar_Gulati@9220a
list the people from THA who are lead investors in Seed Round - Gcalls	Anh_Duong_Van@10396
list the people from SGP who are lead investors in Debt Financing - Jumio	Eduardo_Saverin@ec756
list the people from IND who are lead investors in Seed Round - Sirona Hygiene	Ishan_Singh@622c6
list the people from IND who are lead investors in Series A - authorSTREAM.com	Rajan_Anandan@9fb90
list the people from AUS who are lead investors in Angel Round - SiteMinder	Les_Szekely@6ae0d
list the people from USA who are lead investors in Pre Seed Round - Replay.io	Jesse_Beyroutey@326c1
list the people from BRA who are lead investors in Angel Round - Cyon Equipamentos	José_Carlos_Semenzato@06356
list the people from USA who are lead investors in Grant - Georgetown Venture Lab	Ted_Leonsis@a9721
list the people from USA who are lead investors in Seed Round - AdQuick	Alexis_Ohanian@aa5ed
list the people from USA who are lead investors in Seed Round - Nerd Junkie Inc	Eberle_Francois_Jr@e0966
list the people from COL who are lead investors in Pre Seed Round - Certika	Olson_Ortiz@cc4fe
list the people from GBR who are lead investors in Angel Round - Sen	Charles_Black@29f72
list the people from USA who are lead investors in Series A - Apploi	Andrew_Heyer@99934
list the people from AUS who are lead investors in Debt Financing - K4Coach	Anoop_George@28d37
