list the DEU organizations that invested in funding_round]	DTCP@090b4
list the USA organizations that invested in funding_round]	Breyer_Capital@a3dac
list the ISR organizations that invested in funding_round]	Vertex_Ventures_Israel@04220
list the GBR organizations that invested in funding_round]	Startupbootcamp@326e7
list the MEX organizations that invested in funding_round]	Griffin_Gaming_Partners@9638c
list the CHE organizations that invested in funding_round]	SIX_FinTech_Ventures@ff590
list the RUS organizations that invested in funding_round]	RMI_Partners@e6491
list the ESP organizations that invested in funding_round]	Cemex_Ventures@da99e
list the JPN organizations that invested in funding_round]	Nexon@7c665
list the CAN organizations that invested in funding_round]	Whitecap_Venture_Partners@9fb09
list the FRA organizations that invested in funding_round]	Partech@ae47b
list the SWE organizations that invested in funding_round]	EQT_Ventures@1d1d9
list the AUT organizations that invested in funding_round]	Speedinvest@ef75d
list the CHN organizations that invested in funding_round]	Qiming_Venture_Partners@9e729
list the CRI organizations that invested in funding_round]	Artemis_Growth_Partners@44225
list the NGA organizations that invested in funding_round]	Singularity_Investments@ef036
list the ARE organizations that invested in funding_round]	Shorooq_Partners@0ac2a
list the POL organizations that invested in funding_round]	Movens_Capital@2d1dc
list the HKG organizations that invested in funding_round]	DST_Global@d3fc4
list the IND organizations that invested in funding_round]	Stellaris_Venture_Partners@e5905
list the FIN organizations that invested in funding_round]	Inventure@313cb
list the PAK organizations that invested in funding_round]	Walled_City_Co.@a9c15
list the DNK organizations that invested in funding_round]	Novo_Holdings@8e7c3
