Norman Winarsky is the investment partner in which series_a funding round	Series_A_-_Tempo_AI@8fd07
Tom Wheeler is the investment partner in which series_a funding round	Series_A_-_Twisted_Pair_Solutions@f6bb7
Vittorio Maraghini Garrone is the investment partner in which seed funding round	Seed_Round_-_Responsa@7d557
Ali Byrd is the investment partner in which series_b funding round	Series_B_-_Humio@88d90
Ian Friedman is the investment partner in which series_c funding round	Series_C_-_Shift@14f25
Brendan Dickinson is the investment partner in which series_c funding round	Series_C_-_Embroker@b8ca2
Jason Edwards is the investment partner in which series_b funding round	Series_B_-_Skayle@92418|Series_B_-_Data_Republic@bc7aa|Series_B_-_SirionLabs@8ed73|Series_B_-_Appier@64587|Series_B_-_NoBroker@30873|Series_B_-_Eyeota@0bbd1|Series_B_-_Funding_Societies@805a3|Series_B_-_8x8_Asia@87bc9|Series_B_-_OpenAgent.com.au@993c9|Series_B_-_90_Seconds@80802
Tyler Engh is the investment partner in which seed funding round	Seed_Round_-_Light_Field_Lab@f0081
James Nettleton is the investment partner in which series_b funding round	Series_B_-_Transit@1a75d
Vinoth Jayakumar is the investment partner in which series_c funding round	Series_C_-_Form3@ecc38|Series_C_-_Ravelin@73aa4
Thomas G. McKinley is the investment partner in which series_b funding round	Series_B_-_lifeIMAGE@f79ad
Amias Gerety is the investment partner in which series_b funding round	Series_B_-_Treasury_Prime@9a2f5|Series_B_-_Ocrolus@73824
Bo Shao is the investment partner in which series_b funding round	Series_B_-_Babytree@fbbd4
Scott Goodman is the investment partner in which seed funding round	Seed_Round_-_IR_Dynamics@6cb06
Tom Chi is the investment partner in which series_a funding round	Series_A_-_Dendra_Systems@b2c1d
Franklin Bi is the investment partner in which undisclosed funding round	Funding_Round_-_BCB_Group@4848b
Mehmet Atici is the investment partner in which seed funding round	Seed_Round_-_Orgnostic@06b56|Seed_Round_-_Payhawk@1976b|Seed_Round_-_Apsiyon@69f84|Seed_Round_-_Apsiyon@22386|Seed_Round_-_Trickest@3b4cb
Ozi Amanat is the investment partner in which undisclosed funding round	Funding_Round_-_One97@8f20f
Diane Greene is the investment partner in which series_a funding round	Series_A_-_Nimbula@1649c
Hugo Burge is the investment partner in which seed funding round	Seed_Round_-_Motorway@2edc7
Alex Pasteur is the investment partner in which series_a funding round	Series_A_-_Orchard_Therapeutics@83394|Series_A_-_Owkin@441da|Series_A_-_Owkin@5b5e7
Tom Jessop is the investment partner in which series_c funding round	Series_C_-_Digital_Reasoning@28b1f
Prashanth Prakash is the investment partner in which convertible_note funding round	Convertible_Note_-_HomeLane@74fbc
Yossi Sela is the investment partner in which series_b funding round	Series_B_-_Outbrain@5c43d|Series_B_-_JFrog@e6da1|Series_B_-_PrimeSense@a2646|Series_B_-_Samanage@9ec45
Karimah Es Sabar is the investment partner in which seed funding round	Seed_Round_-_Sitka_Biopharma@2c162
Joshua Kushner is the investment partner in which series_c funding round	Series_C_-_Artsy@e4650|Series_C_-_Airtable@bc336
James Wise is the investment partner in which series_a funding round	Series_A_-_Demodesk@e06b7|Series_A_-_Opbeat@abb4d|Series_A_-_Pusher@8f312|Series_A_-_Kaia_Health@892fd|Series_A_-_Depop@53de5|Series_A_-_Forecast@e5d2a|Series_A_-_Sketchfab@c44b0
Bryan Kim is the investment partner in which series_b funding round	Series_B_-_Zenflow@708f8
Hasan Aslanoba is the investment partner in which angel funding round	Angel_Round_-_Fit&Color@35403|Angel_Round_-_AnyMeeting@68e25
Vallabh Bhanshali is the investment partner in which series_a funding round	Series_A_-_Arzooo.com@a9251
Hian Goh is the investment partner in which series_c funding round	Series_C_-_Chope@ea8c3
Chris Priebe is the investment partner in which series_a funding round	Series_A_-_Casai@dd2c1|Series_A_-_SingularCover@4496c
Kurt Ramirez is the investment partner in which seed funding round	Seed_Round_-_Pronto_Housing@a8f34|Seed_Round_-_Finley_Technologies@c73f8
Jack Crawford is the investment partner in which seed funding round	Seed_Round_-_TaskHuman@da5f3
Christian Zabbal is the investment partner in which series_a funding round	Series_A_-_Solantro_Semiconductor@e91e4
John Backus is the investment partner in which seed funding round	Seed_Round_-_Koofers@d900b
Wan Li Zhu is the investment partner in which series_a funding round	Series_A_-_TVision@60386
Camille Samuels is the investment partner in which series_b funding round	Series_B_-_UNITY_Biotechnology@975c9|Series_B_-_Spirox@3ecf1|Series_B_-_UNITY_Biotechnology@9d126|Series_B_-_Kythera_Biopharmaceuticals@300ce|Series_B_-_Achaogen@085e6
Morgan Beller is the investment partner in which series_a funding round	Series_A_-_Stoke_Space@1fb6d|Series_A_-_Ramp@b5f4c
Alan Salzman is the investment partner in which series_c funding round	Series_C_-_BridgeLux@acb07
Kevin Brown is the investment partner in which series_a funding round	Series_A_-_Fina_Technologies@b9c7b|Series_A_-_Sentrian@1f941|Series_A_-_Struq@aaefc|Series_A_-_Intelligize@f4379
Sam Smith-Eppsteiner is the investment partner in which seed funding round	Seed_Round_-_Futureproof@cb1f7|Seed_Round_-_FutureProof_Technologies@13d8d
John Cambier is the investment partner in which angel funding round	Angel_Round_-_71lbs@1be1c
John Rosenberg is the investment partner in which series_e funding round	Series_E_-_NewVoiceMedia@ed972|Series_E_-_Zepz@2ec9a
Chris Burch is the investment partner in which seed funding round	Seed_Round_-_Upstack@f84a6
Patrick Chung is the investment partner in which seed funding round	Seed_Round_-_Guideline@64ec4|Seed_Round_-_IFTTT@c2e97|Seed_Round_-_Landit@75965|Seed_Round_-_kea@7dc6f|Seed_Round_-_Parts_Market@a0740|Seed_Round_-_Rest_Devices@0f8d5|Seed_Round_-_Uvaro@4b711|Seed_Round_-_Ravel_Law@1a0c1|Seed_Round_-_Kensho@d12f1|Seed_Round_-_ThirdLove@415ba|Seed_Round_-_CrowdMed@6c368|Seed_Round_-_Service@12238
Evren Bilimer is the investment partner in which series_b funding round	Series_B_-_Thrive_Market@0caa3
Bonnie Wang is the investment partner in which debt_financing funding round	Debt_Financing_-_Chushou@dea96
Jason Heltzer is the investment partner in which seed funding round	Seed_Round_-_Tovala@2c9f6
Casey Tansey is the investment partner in which post_ipo_equity funding round	Post-IPO_Equity_-_ReShape_Lifesciences@ef9d9|Post-IPO_Equity_-_ReShape_Lifesciences@6cf50|Post-IPO_Equity_-_ReShape_Lifesciences@c090e
Meghan Sharp is the investment partner in which series_d funding round	Series_D_-_Calysta@25243
Yusuke Murata is the investment partner in which pre_seed funding round	Pre_Seed_Round_-_Crezit@61ac8
Michael Carney is the investment partner in which series_b funding round	Series_B_-_ChowNow@eec4f
Matt Abrams is the investment partner in which convertible_note funding round	Convertible_Note_-_SlamData@65c5d|Convertible_Note_-_Customer.io@dcc1f
Pawel Schapiro is the investment partner in which seed funding round	Seed_Round_-_Invision_AI@3846a
Yoni Cheifetz is the investment partner in which private_equity funding round	Private_Equity_Round_-_Personetics@61168|Private_Equity_Round_-_Teads_US@438ca
Antoine Nussenbaum is the investment partner in which seed funding round	Seed_Round_-_Lick@4a5f3
Stephen Glancey is the investment partner in which undisclosed funding round	Funding_Round_-_Admiral_Taverns@20a88
Matthew Katten is the investment partner in which series_d funding round	Series_D_-_ATAI_Life_Sciences@9225f
Mato Peric is the investment partner in which seed funding round	Seed_Round_-_Superchat@b6a90|Seed_Round_-_fortú@7d3e7|Seed_Round_-_Lori_Systems@4581d|Seed_Round_-_Coya@e4c91|Seed_Round_-_NUMA_Group_(formerly_COSI_Group)@0a710|Seed_Round_-_Velocity@bd26d|Seed_Round_-_Even@51801|Seed_Round_-_Zenyum@f40d0|Seed_Round_-_Valoreo@cd884|Seed_Round_-_Una_Brands@e7550|Seed_Round_-_Refyne@27db4|Seed_Round_-_Syfe@27246|Seed_Round_-_WOMBO@8aa75|Seed_Round_-_Sorare@1d713|Seed_Round_-_MORI@f514d|Seed_Round_-_Denario@f3f05|Seed_Round_-_Zencargo@90e5e
Robert Higginson is the investment partner in which seed funding round	Seed_Round_-_BrainWaveBank@bcf79|Seed_Round_-_TriVirum@67a5b|Seed_Round_-_BrainWaveBank@4edfa
Byron Deeter is the investment partner in which series_d funding round	Series_D_-_Glint@2dc08|Series_D_-_Cornerstone_OnDemand@85084|Series_D_-_SendGrid@a3396|Series_D_-_DoubleDutch@e1890|Series_D_-_Instructure@bfc41|Series_D_-_ServiceTitan@2cf4b|Series_D_-_Guild_Education@92683|Series_D_-_Box@7b4ef|Series_D_-_Twilio@53d17
Lake Dai is the investment partner in which seed funding round	Seed_Round_-_Venti_Technologies@95ac4
Jeppe Høier is the investment partner in which seed funding round	Seed_Round_-_Ofload@2c91b
Doug Derwin is the investment partner in which series_c funding round	Series_C_-_Sauce_Labs@868f9
Anton Inshutin is the investment partner in which series_c funding round	Series_C_-_2can@ad436|Series_C_-_TIER_Mobility@dddb9
Ed Fries is the investment partner in which series_a funding round	Series_A_-_Bit_Fry_Game_Studios@9e091
Michael Levinson is the investment partner in which series_b funding round	Series_B_-_Parse.ly@1ab9f
Elaine Coughlan is the investment partner in which series_b funding round	Series_B_-_Atlantic_Therapeutics@733ca
David Coit is the investment partner in which series_c funding round	Series_C_-_Boost_Payment_Solutions@f371c
Sid Krommenhoek is the investment partner in which convertible_note funding round	Convertible_Note_-_Pronto@3fe04
Max Gazor is the investment partner in which series_c funding round	Series_C_-_Xamarin@ecbe5|Series_C_-_Usermind@425ec|Series_C_-_Cribl@76a7e|Series_C_-_Airtable@bc336|Series_C_-_Simplivity@08c1d|Series_C_-_Diamanti@c7f67
Richard Reed is the investment partner in which seed funding round	Seed_Round_-_Fiit@114e6|Seed_Round_-_Tiney@493af|Seed_Round_-_Lick@4a5f3
Kristian Andersen is the investment partner in which series_d funding round	Series_D_-_Octiv@b3d28|Series_D_-_Integrate@242dd
Jay Choi is the investment partner in which series_c funding round	Series_C_-_PlaySight_Interactive@47d08
John Sjolander is the investment partner in which seed funding round	Seed_Round_-_Mediatool@c119c|Seed_Round_-_Passendo@058b0
Matt Warta is the investment partner in which series_c funding round	Series_C_-_PerfectServe@ea038
Asad Khaliq is the investment partner in which series_a funding round	Series_A_-_Augtera_Networks@b9991|Series_A_-_Tara_AI@0fcdc
Alfred Lin is the investment partner in which series_a funding round	Series_A_-_DoorDash@367ad|Series_A_-_Found@67677|Series_A_-_Truework@0153a|Series_A_-_Faire@06cf7|Series_A_-_Cobalt@f5d46|Series_A_-_Stella_&_Dot@82799|Series_A_-_Airbnb@c959a|Series_A_-_OpenTable@d0c85|Series_A_-_Kiwi,_Inc.@e5047|Series_A_-_Instacart@aec91|Series_A_-_Zipline@d9d7a|Series_A_-_Prologue@dbdb5
Alejandro Rodriguez is the investment partner in which series_a funding round	Series_A_-_Compareemcasa@8dc12
Sameer Shisodia is the investment partner in which seed funding round	Seed_Round_-_MatchLog@da15d
Rob Heimann is the investment partner in which series_a funding round	Series_A_-_PerfectServe@24074
John Carrafiell is the investment partner in which private_equity funding round	Private_Equity_Round_-_Lineage_Logistics@77f63|Private_Equity_Round_-_Lineage_Logistics@94c37|Private_Equity_Round_-_Lineage_Logistics@4591b
Joi Ito is the investment partner in which seed funding round	Seed_Round_-_Helium@25ef4
Krishna Sudheendra is the investment partner in which series_a funding round	Series_A_-_MyDoc@0d655
Marie Ekeland is the investment partner in which seed funding round	Seed_Round_-_Butterfly.ai@d9884|Seed_Round_-_Shine.fr@b9042
Barbod Namini is the investment partner in which series_c funding round	Series_C_-_BUX@e31f7|Series_C_-_BUX@6a8e0|Series_C_-_Solarisbank@997f5
Robert Kunze-Concewitz is the investment partner in which corporate_round funding round	Corporate_Round_-_Tannico@5c4b4
Jonathan Ord is the investment partner in which private_equity funding round	Private_Equity_Round_-_Flexion_Energy@c3007
Pankaj Raina is the investment partner in which series_b funding round	Series_B_-_Fingerlix@84ff1|Series_B_-_Ripplr@b94c3
Bryan Roberts is the investment partner in which series_a funding round	Series_A_-_Cerulean_Pharma@ce678|Series_A_-_Grand_Rounds_Health@327f6|Series_A_-_Receptos@79e3b|Series_A_-_Kyruus@2829c|Series_A_-_Ariosa_Diagnostics@02c59|Series_A_-_Castlight_Health@8f6c3|Series_A_-_Stride_Health@9dffb|Series_A_-_Federation_Bio@21086|Series_A_-_Hua_Medicine@2d5f5|Series_A_-_Fate_Therapeutics@1ca26|Series_A_-_Doctor_On_Demand@5d8a1|Series_A_-_Athenahealth@a41b4|Series_A_-_Advance_Medical@eaa32|Series_A_-_Ironwood_Pharmaceuticals@cbb91|Series_A_-_Ikaria@c1bdc|Series_A_-_Cloudflare@56b4f|Series_A_-_Achaogen@e3519|Series_A_-_Lyra_Health@6d2b3
Amanda Reed is the investment partner in which series_d funding round	Series_D_-_Voxify@d9c57
Haakon Brunell is the investment partner in which pre_seed funding round	Pre_Seed_Round_-_FinAccess@95d4c|Pre_Seed_Round_-_Praxilabs@f2bb2|Pre_Seed_Round_-_Think-it@d9cd6
Christine Tsai is the investment partner in which pre_seed funding round	Pre_Seed_Round_-_Abound@3de98
Jarrett Collins is the investment partner in which series_c funding round	Series_C_-_Everyday_Health_Group@9f184
Arama Kukutai is the investment partner in which series_a funding round	Series_A_-_Hi_Fidelity_Genetics@1a1e9|Series_A_-_Crop_Pro_Insurance@e7922|Series_A_-_BioLumic@4972b|Series_A_-_Taranis@080ae|Series_A_-_BioLumic@73747
Kathryn Cartini is the investment partner in which pre_seed funding round	Pre_Seed_Round_-_BridgeCare@850a4
Andrew Rubinstein is the investment partner in which post_ipo_debt funding round	Post-IPO_Debt_-_Centessa_Pharmaceuticals@ae96b
Gary Kurtzman is the investment partner in which series_d funding round	Series_D_-_Crescendo_Bioscience@7b953|Series_D_-_Sotera_Wireless@4b007|Series_D_-_Avid_Radiopharmaceuticals@8acb1|Series_D_-_PixelOptics@ab104
Björn von Siemens is the investment partner in which series_a funding round	Series_A_-_Caresyntax@970d0
