list the GBR people who invested in Pre Seed Round - Ethale Books App	Miles_Morland@e7173
list the USA people who invested in Convertible Note - Wrapify	Jason_Calacanis@21433
list the USA people who invested in Seed Round - PayZen	Phin_Upham@5ddaf
list the USA people who invested in Series A - Zembula	Jason_Calacanis@21433
list the IDN people who invested in Debt Financing - Gayo Capital	Ishara_Yusdian@8c37d
list the USA people who invested in Convertible Note - STEEZY	Jason_Calacanis@21433
list the USA people who invested in Convertible Note - Jibe	Jason_Calacanis@21433
list the USA people who invested in Seed Round - The Last Guide Company	Jason_Calacanis@21433
list the GHA people who invested in Series A - SamBoad Business Group Limited	Natasha_Apeadjei-Duodu@6e03b
list the USA people who invested in Seed Round - Scroll	Jason_Calacanis@21433
list the ROM people who invested in Series A - Vector Watch	Radu_Georgescu@63db2
list the USA people who invested in Venture Round - Talla	Jason_Calacanis@21433
list the USA people who invested in Series A - Medium	Jason_Calacanis@21433
list the USA people who invested in Seed Round - OpenFan	Jason_Calacanis@21433
list the USA people who invested in Seed Round - Hello Scout Inc.	Jason_Calacanis@21433
list the USA people who invested in Venture Round - Numbers Protocol	Steve_Chen@872bf
list the GHA people who invested in Series A - PISTIS And Associates	P._Addo-Nyarko@2c2de
list the IND people who invested in Seed Round - SanKash	Rishi_Kajaria@414b0
list the NLD people who invested in Pre Seed Round - Befundo.com	Michael_Maximilian_Sepp@7f628
list the UKR people who invested in Seed Round - P2Pseller	Oleg_Krot@a36dd
list the USA people who invested in Pre Seed Round - Guardian Circle	Jason_Calacanis@21433
list the USA people who invested in Seed Round - Myro	Trevor_Sumner@8a3f8
list the USA people who invested in Angel Round - FirstCut	Jorge_Soto@06d90
list the USA people who invested in Seed Round - Captiv8	Jason_Calacanis@21433
list the USA people who invested in Seed Round - Eyeona	Michael_Burry@fe768
list the IND people who invested in Private Equity Round - Infovys	Rohit_Dalvi@18a6c
list the USA people who invested in Series C - Signpost	Jason_Calacanis@21433
list the USA people who invested in Series A - Reconstruct	Cliff_Holekamp@9cf88
list the USA people who invested in Debt Financing - Product Revolution Consulting	Daniel_O'Leary@70a8b
list the CHL people who invested in Pre Seed Round - UHOMIE	Alejandro_Revecco@c73cc
list the USA people who invested in Series C - Whisper	Jason_Calacanis@21433
list the USA people who invested in Seed Round - PayRange	Jerry_Murdock@34c82
list the USA people who invested in Seed Round - Pipe	Naval_Ravikant@52432|Sky_Dayton@d2761
list the USA people who invested in Seed Round - REscour	Jason_Calacanis@21433
list the GBR people who invested in Post-IPO Equity - AudioEye	Sandy_Purcell@1eda8
list the DEU people who invested in Series A - Sdui	David_Nothacker@b796e|Martin_Ostermayer@747ad|Udo_Schloemer@39b71|Julius_Koehler@88565|Nicolaus_Schefenacker@2c6f4|Dirk_Freise@c7bf0
list the USA people who invested in Seed Round - Stowaway Cosmetics	Jason_Calacanis@21433
list the BRA people who invested in Pre Seed Round - Quero Education	Romero_Rodrigues@e8096
list the USA people who invested in Seed Round - Inspectiv	Jenny_Lefcourt@54a78
list the USA people who invested in Series A - Inkd.com	Mika_Salmi@c3917
list the USA people who invested in Seed Round - Prime Discoveries	Chuck_Zegar@2aa9b
list the USA people who invested in Funding Round - InSpace Incorporated	Jonathan_Fentzke@2afdd
list the USA people who invested in Funding Round - BootstrapLabs	Nicolai_Wadstrom@03ab7
list the USA people who invested in Seed Round - GeneDrop	Jonathan_Boutelle@09d9e
list the SGP people who invested in Venture Round - Enjoyor	Yongjie_Yao@25ad8
list the USA people who invested in Pre Seed Round - Live Furnish	Jason_Calacanis@21433
list the USA people who invested in Debt Financing - Momunt	Jason_Calacanis@21433
list the GRC people who invested in Pre Seed Round - Geopay.me	Antonis_Valamontes@d8d5a
list the USA people who invested in Seed Round - meaZr	Jason_Calacanis@21433
list the USA people who invested in Seed Round - Capsule Social	Naval_Ravikant@52432
list the USA people who invested in Series A - Atrium LTS	Niko_Bonatsos@a0c2a
list the USA people who invested in Seed Round - illumis	Jason_Calacanis@21433
list the USA people who invested in Seed Round - Cloud of Goods	Jeff_Weiner@9be6a
list the USA people who invested in Series A - PayRange	Jerry_Murdock@34c82
list the USA people who invested in Seed Round - Huckle	Jason_Calacanis@21433
list the USA people who invested in Angel Round - CardClan	Adil_Saleh@f5d11
list the USA people who invested in Seed Round - OneDrop	Jason_Calacanis@21433
list the FRA people who invested in Pre Seed Round - Caption	Denis_Lafont-Trevisan@ccd00
list the IND people who invested in Pre Seed Round - Frontline Investments India	Shane_Donald@d1a05
list the USA people who invested in Seed Round - Squirro	Alex_Ott@32e60
list the USA people who invested in Series C - Uber	Scott_Belsky@81cfe
list the USA people who invested in Seed Round - Filtricine	Zen_Chu@b579f
list the USA people who invested in Series A - Shots Studios	Jason_Calacanis@21433
list the USA people who invested in Series A - Streamweaver	Chris_Kelly@aa17c
list the USA people who invested in Convertible Note - Tinychef	Swamy_Kotagiri@d278c
list the USA people who invested in Series A - Daily.co	Jenny_Lefcourt@54a78
list the GBR people who invested in Seed Round - Nanoprecise Sci Corp	Brian_Craig@38948
list the ARG people who invested in Seed Round - Quansa	Claire_Diaz-Ortiz@ef217
list the USA people who invested in Series C - CyCognito	Dan_Scheinman@62bb5
list the IND people who invested in Seed Round - Rocketbox	Haresh_Chawla@fa77a
list the USA people who invested in Seed Round - Zephyrus Biosciences	Jenny_Rooke@419fe
list the NLD people who invested in Series B - Befundo.com	Michael_Maximilian_Sepp@7f628
list the IND people who invested in Convertible Note - HOGGY (Litifer Technologies Pvt. Ltd.)	Rajesh_Sawhney@d0fc9
list the IRL people who invested in Private Equity Round - MedPro Billing Solutions	Ruth_Johnston@e935b
list the USA people who invested in Seed Round - Underground Cellar	Jason_Calacanis@21433
list the BRA people who invested in Series A - Ascenty	Romero_Rodrigues@e8096
list the USA people who invested in Seed Round - Richie Bello	Richie_Bello@c0069
list the USA people who invested in Seed Round - P2Pseller	Yura_Lazebnikov@a507e
list the MEX people who invested in Seed Round - Rocket.La	Anna_Raptis@f98c7
list the NGA people who invested in Pre Seed Round - Kitcart	Elon_Jobs@8426e
list the USA people who invested in Pre Seed Round - OndeCare	Lynn-Ann_Gries@f0be1
list the GBR people who invested in Seed Round - Biomage	Nadav_Rosenberg@0fc1c
list the USA people who invested in Seed Round - AgentSync	Elad_Gil@0dbc0
list the USA people who invested in Private Equity Round - Milwaukee Bucks Inc.	Marc_Lasry@d99d0
list the USA people who invested in Pre Seed Round - Xendoo	Jason_Calacanis@21433
list the USA people who invested in Series A - Cozy	Jason_Calacanis@21433
list the USA people who invested in Seed Round - Kush Marketplace	Jason_Calacanis@21433
list the ISR people who invested in Series A - Vendia	Noam_Kaiser@a64ea
list the ARE people who invested in Pre Seed Round - GrowValley	Jazeer_Jamal@ce236
list the ISR people who invested in Seed Round - Storycards	Gil_Rabbi@3f559
list the USA people who invested in Series A - Mouth Foods	Jason_Calacanis@21433
list the USA people who invested in Seed Round - Butterfleye	Jason_Calacanis@21433
list the USA people who invested in Seed Round - Poliglota	Austen_Allred@d1839|Justin_Waldron@3e461|Doug_Chertok@bfcd5|Roy_Chung@7f031
list the USA people who invested in Venture Round - MobileCoin	Kenzi_Wang@0e728
list the USA people who invested in Angel Round - Ramen	Jason_Calacanis@21433
list the USA people who invested in Pre Seed Round - Payourse	Rene_Reinsberg@b6f02|Marek_Olszewski@b9ec2|Ed_Walters@44363
list the USA people who invested in Seed Round - Zymergen	Jenny_Rooke@419fe
list the USA people who invested in Seed Round - Betagig	Jason_Calacanis@21433
