seed funding rounds that Travly launched	Seed_Round_-_Travly@3a169
pre_seed funding rounds that HUNTY launched	Pre_Seed_Round_-_HUNTY@52f71
series_b funding rounds that Vzoom Creditech launched	Series_B_-_Vzoom_Creditech@81694
seed funding rounds that Wellness Awareness launched	Seed_Round_-_Wellness_Awareness@d5d6d
series_b funding rounds that Kuaifawu.com launched	Series_B_-_Kuaifawu.com@eadbc
seed funding rounds that Finanbest launched	Seed_Round_-_Finanbest@fd2b9|Seed_Round_-_Finanbest@5782e
seed funding rounds that Unu motors launched	Seed_Round_-_Unu_motors@92e66
series_c funding rounds that Teligene launched	Series_C_-_Teligene@adac6
seed funding rounds that Temizlikyolda launched	Seed_Round_-_Temizlikyolda@ae4b3|Seed_Round_-_Temizlikyolda@2b41d
seed funding rounds that RSI (Reel Solar Inc) launched	Seed_Round_-_RSI_(Reel_Solar_Inc)@d2006
private_equity funding rounds that Tykn launched	Private_Equity_Round_-_Tykn@4b855
series_c funding rounds that Cloud Cruiser launched	Series_C_-_Cloud_Cruiser@814cd
initial_coin_offering funding rounds that SONM launched	Initial_Coin_Offering_-_SONM@c9d53
angel funding rounds that UUPaotui launched	Angel_Round_-_UUPaotui@e185e
seed funding rounds that ZuriHq launched	Seed_Round_-_ZuriHq@f1680
seed funding rounds that Trusst Brands launched	Seed_Round_-_Trusst_Brands@dcaa5|Seed_Round_-_Trusst_Brands@2086e|Seed_Round_-_Trusst_Brands@a2211
pre_seed funding rounds that Digified launched	Pre_Seed_Round_-_Digified@c887b
pre_seed funding rounds that Vigilitech launched	Pre_Seed_Round_-_Vigilitech@1583c
pre_seed funding rounds that Ruksack launched	Pre_Seed_Round_-_Ruksack@e559d
series_b funding rounds that Devicescape launched	Series_B_-_Devicescape@4a5dd
debt_financing funding rounds that Valoe Corporation launched	Debt_Financing_-_Valoe_Corporation@b1829
seed funding rounds that Electronic Lab Logs launched	Seed_Round_-_Electronic_Lab_Logs@39f26
seed funding rounds that Third Wave Farms launched	Seed_Round_-_Third_Wave_Farms@f6793
equity_crowdfunding funding rounds that Neuvote launched	Equity_Crowdfunding_-_Neuvote@6bf7c
debt_financing funding rounds that Events Hotels launched	Debt_Financing_-_Events_Hotels@e1c64
series_a funding rounds that Dot & Bo launched	Series_A_-_Dot_&_Bo@2fa99
series_a funding rounds that Reciprocity launched	Series_A_-_Reciprocity@231c3
series_b funding rounds that Fios Genomics launched	Series_B_-_Fios_Genomics@2b721
debt_financing funding rounds that jane.app launched	Debt_Financing_-_jane.app@5a2f9
pre_seed funding rounds that Creavision Technologies launched	Pre_Seed_Round_-_Creavision_Technologies@a3fa5
grant funding rounds that SurgiData launched	Grant_-_SurgiData@6c119
pre_seed funding rounds that Kanda launched	Pre_Seed_Round_-_Kanda@ef8d7
series_b funding rounds that Fazland launched	Series_B_-_Fazland@7c9ce
series_b funding rounds that Xiaomi launched	Series_B_-_Xiaomi@18dd0
grant funding rounds that Marmota Ltd. launched	Grant_-_Marmota_Ltd.@b4dfc
pre_seed funding rounds that MiTienda Labs launched	Pre_Seed_Round_-_MiTienda_Labs@2b32b|Pre_Seed_Round_-_MiTienda_Labs@c26f4
series_c funding rounds that Sopogy launched	Series_C_-_Sopogy@cc64b
series_a funding rounds that UpScalio launched	Series_A_-_UpScalio@8d665
seed funding rounds that COI Energy Services launched	Seed_Round_-_COI_Energy_Services@269df
series_a funding rounds that beeba launched	Series_A_-_beeba@c1323
series_b funding rounds that Zoox Smart Data launched	Series_B_-_Zoox_Smart_Data@21299
debt_financing funding rounds that Carena launched	Debt_Financing_-_Carena@2dd68
series_b funding rounds that TrustedID launched	Series_B_-_TrustedID@4bab6
undisclosed funding rounds that Waveblade launched	Funding_Round_-_Waveblade@9b651
series_c funding rounds that Chain launched	Series_C_-_Chain@a043e
seed funding rounds that Ground launched	Seed_Round_-_Ground@94890
grant funding rounds that Mudlark launched	Grant_-_Mudlark@65a91
pre_seed funding rounds that Zopnik launched	Pre_Seed_Round_-_Zopnik@711ce
grant funding rounds that Vibetech srl launched	Grant_-_Vibetech_srl@7848d|Grant_-_Vibetech_srl@87ca9
pre_seed funding rounds that blockchain.art launched	Pre_Seed_Round_-_blockchain.art@6edb1
debt_financing funding rounds that DueCourse launched	Debt_Financing_-_DueCourse@96c0b
angel funding rounds that Anpeiwang launched	Angel_Round_-_Anpeiwang@f899a
seed funding rounds that Gamification Lab launched	Seed_Round_-_Gamification_Lab@a830c
seed funding rounds that LifeVoxel launched	Seed_Round_-_LifeVoxel@c680f
seed funding rounds that SV-MEDTECH launched	Seed_Round_-_SV-MEDTECH@4e26a
undisclosed funding rounds that Vixlet launched	Funding_Round_-_Vixlet@19776|Funding_Round_-_Vixlet@40824
post_ipo_debt funding rounds that Ziff Davis launched	Post-IPO_Debt_-_Ziff_Davis@5989d
series_b funding rounds that Symform launched	Series_B_-_Symform@95244
seed funding rounds that AD-Pure launched	Seed_Round_-_AD-Pure@07a5d
series_a funding rounds that Intersect ENT launched	Series_A_-_Intersect_ENT@f738d
debt_financing funding rounds that Myforexeye Fintech Private Limited launched	Debt_Financing_-_Myforexeye_Fintech_Private_Limited@fbd32
series_b funding rounds that MASS HORN GROUP launched	Series_B_-_MASS_HORN_GROUP@17ef5
grant funding rounds that MPG Manifattura Plastica launched	Grant_-_MPG_Manifattura_Plastica@679cf
private_equity funding rounds that COOLA launched	Private_Equity_Round_-_COOLA@1b394
grant funding rounds that EasyPol launched	Grant_-_EasyPol@da0f6|Grant_-_EasyPol@d085f
seed funding rounds that Datagusto launched	Seed_Round_-_Datagusto@2bc38
series_b funding rounds that olook launched	Series_B_-_olook@e707b
convertible_note funding rounds that LeanMed launched	Convertible_Note_-_LeanMed@501ff
seed funding rounds that Antavo Loyalty Management Platform launched	Seed_Round_-_Antavo_Loyalty_Management_Platform@918f3|Seed_Round_-_Antavo_Loyalty_Management_Platform@77cc7
pre_seed funding rounds that Trust Stamp launched	Pre_Seed_Round_-_Trust_Stamp@63fbb
seed funding rounds that BIOMAE launched	Seed_Round_-_BIOMAE@d6f6c
grant funding rounds that Delox launched	Grant_-_Delox@5cb98
series_a funding rounds that Hy2Care launched	Series_A_-_Hy2Care@1bed4
series_c funding rounds that Aspiration launched	Series_C_-_Aspiration@1b7de
angel funding rounds that Accept.inc launched	Angel_Round_-_Accept.inc@769f1|Angel_Round_-_Accept.inc@89fe5
series_a funding rounds that Playco launched	Series_A_-_Playco@4cb5a
series_c funding rounds that Associated Content launched	Series_C_-_Associated_Content@c01b4
debt_financing funding rounds that Haus Bioceuticals launched	Debt_Financing_-_Haus_Bioceuticals@9a5e3
seed funding rounds that Zeplin launched	Seed_Round_-_Zeplin@ebdb3|Seed_Round_-_Zeplin@3ac37|Seed_Round_-_Zeplin@2ba0a|Seed_Round_-_Zeplin@cb1f2
seed funding rounds that MadKudu launched	Seed_Round_-_MadKudu@a25fc|Seed_Round_-_MadKudu@0a9f7
seed funding rounds that FishingBooker launched	Seed_Round_-_FishingBooker@8537b
angel funding rounds that DanceJam launched	Angel_Round_-_DanceJam@55e10
angel funding rounds that IF Entertainment launched	Angel_Round_-_IF_Entertainment@6f3f2
equity_crowdfunding funding rounds that Stalkthis launched	Equity_Crowdfunding_-_Stalkthis@62d7d
series_b funding rounds that eRealty.com launched	Series_B_-_eRealty.com@2ce68
seed funding rounds that Bbsit launched	Seed_Round_-_Bbsit@a58c5
series_c funding rounds that Gainworld launched	Series_C_-_Gainworld@25727
series_a funding rounds that StarStock launched	Series_A_-_StarStock@5b413
equity_crowdfunding funding rounds that Bangee launched	Equity_Crowdfunding_-_Bangee@7b971
seed funding rounds that Shakr.com launched	Seed_Round_-_Shakr.com@55de2
pre_seed funding rounds that Rezuro launched	Pre_Seed_Round_-_Rezuro@b8c60|Pre_Seed_Round_-_Rezuro@e88ca
seed funding rounds that Layer launched	Seed_Round_-_Layer@420e6|Seed_Round_-_Layer@b1b4b
pre_seed funding rounds that Clicks Pte. Ltd. launched	Pre_Seed_Round_-_Clicks_Pte._Ltd.@10ef9
series_a funding rounds that RelateIQ launched	Series_A_-_RelateIQ@b027a
series_a funding rounds that eShop Ventures launched	Series_A_-_eShop_Ventures@bdc61
debt_financing funding rounds that Fastor Systems, Inc. launched	Debt_Financing_-_Fastor_Systems,_Inc.@54e96
series_e funding rounds that Salsify launched	Series_E_-_Salsify@96462
grant funding rounds that BufferBox launched	Grant_-_BufferBox@849c6|Grant_-_BufferBox@3cefc
seed funding rounds that DigiKhata launched	Seed_Round_-_DigiKhata@4591a
seed funding rounds that FINN launched	Seed_Round_-_FINN@b23aa
