Aminur Rashid invested in what Home Improvement companies	Pickaboo.com@634d1
Rahul Mishra invested in what Software companies	ecadema_-_Online_Learning@5848d
Larisa Serova invested in what Advertising companies	Befundo.com@39d49
Jason Calacanis invested in what Events companies	CultureForce@448e1
Justin Bastian invested in what Advertising companies	Socent_Studios@62fcb
Jit Saxena invested in what Business Intelligence companies	Wiser_Solutions@4c920
Trevor Sumner invested in what Manufacturing companies	Myro@02a56
Kenzi Wang invested in what Consumer Software companies	Current_Mobile@f7769
Shane Donald invested in what Finance companies	Frontline_Investments_India@204cc
Sunder Nookala invested in what Internet companies	Big.Jobs@33854
Jennifer Wyatt invested in what Electronic Design Automation (EDA) companies	GigWrks@02dc4
Ira Lubert invested in what Consumer companies	Houwzer@8a9e3
Brian Ross invested in what Network Security companies	WTI_(Western_Telematic_Inc)@fbbbb
Jim Eberlin invested in what Legal companies	Juristat@d8bcb
Ishara Yusdian invested in what Waste Management companies	Gayo_Capital@40875
Edward Lando invested in what Travel Accommodations companies	Pronto@2b843
Schnidar Harald invested in what mHealth companies	SCARLETRED@dada3
Jason Calacanis invested in what Scheduling companies	Thalamus@0cb9c
Jason Calacanis invested in what Sharing Economy companies	Wrapify@52d44
Cassio Jose Krupinsk invested in what Internet companies	OXIBIZ@1eb16
Ruth Johnston invested in what Accounting companies	MedPro_Billing_Solutions@1fd24
Antonis Valamontes invested in what Mobile Payments companies	Geopay.me@05134
Marek Olszewski invested in what Software companies	Payourse@56e0a
Mathias Eklof invested in what Photography companies	Let's_Enhance@15cd9
Eric Reiner invested in what Software companies	Habi@dfefd
Kevin Efrusy invested in what Payments companies	Flash@fcd07
Yura Lazebnikov invested in what Logistics companies	P2Pseller@af164
Aamir Rehman invested in what Peer to Peer companies	Defynance@68b2e
Dirk Freise invested in what Apps companies	Sdui@ef0e7
Sushil Sharma invested in what B2C companies	Marwari_Catalysts@c53cb
Rajiv Dadlani invested in what Retail companies	Wellness_Forever_Medicare@c5515
Jason Finger invested in what Analytics companies	Wunderkind_(formerly_BounceX)@9e067
Mike Shim invested in what FinTech companies	DigiSure@59044
Ken Leonard invested in what Content companies	JoyFLIPS@ae138
Sandy Purcell invested in what Audio companies	AudioEye@7b5c2
Jos White invested in what Events companies	Splash@429ea
Mike Shim invested in what Enterprise Software companies	DigiSure@59044
Diane Harvey invested in what Virtual Reality companies	133T.@5db8f
Steen Ulf Jensen invested in what Analytics companies	Cavea@de8fb
Fabio Rosati invested in what Ride Sharing companies	DigiSure@59044
Sagar Ratilal Bavarva invested in what Energy Management companies	Aasan_Industries@742d2|HydraX_Incorporation@66e33
Sophia Collier invested in what Marketplace companies	Pronto@2b843
Swamy Kotagiri invested in what Cooking companies	Tinychef@6c886
Steve Chen invested in what Data Integration companies	Numbers_Protocol@a3fd2
Jason Calacanis invested in what Internet companies	ClosedWon@1ae70|Mouth_Foods@65fa9|Talla@f7329|TutorMe@11108|LÜK_Network@7e9b0|Medium@35c41|tonebase@fab3f|Freeplay@f4d1f|ToutApp@67161|Red_Tricycle@78154
Oleg Krot invested in what Shipping companies	P2Pseller@af164
Immad Akhund invested in what Travel Accommodations companies	Pronto@2b843
Jennifer Wyatt invested in what Artificial Intelligence companies	GigWrks@02dc4
Tarun Poddar invested in what Non Profit companies	KaeMe@3882d
Jason Calacanis invested in what Broadcasting companies	axle_ai@46a57
Michael Gordon invested in what Publishing companies	Image_Space_Media@011ff
Uchechukwu Ajuzieogu invested in what Information Technology companies	Ehubber@d66c6
Steen Ulf Jensen invested in what Artificial Intelligence companies	Cavea@de8fb
Alex Ott invested in what Software companies	Memonic@34c27|Squirro@f9f7a
Jonathan Wu invested in what Web Design companies	Website_Pros@3452a
Jit Saxena invested in what Retail Technology companies	Wiser_Solutions@4c920
Sashi Reddi invested in what Marketing Automation companies	ShepHertz@0af78
Jason Calacanis invested in what Mobile Apps companies	Freeplay@f4d1f|ZenSports@939d4|ClosedWon@1ae70|WhereBy.Us@e29e2
Jason Calacanis invested in what Test and Measurement companies	Density@9fce6
Michael Altrichter invested in what Internet companies	App_Radar@10eb2
Lou Kerner invested in what Digital Media companies	Polar@3f532
Jason Calacanis invested in what Cryptocurrency companies	ZenSports@939d4
Marc Onetto invested in what Fashion companies	Swap.com@63ebb
Julie Meyer invested in what Marketplace companies	Lime&Tonic@18bf8
Jason Calacanis invested in what Facility Management companies	Flow_Laboratories@e4139
Diane Harvey invested in what Recruiting companies	133T.@5db8f
Eric Reiner invested in what Real Estate Investment companies	Habi@dfefd
Fabio Rosati invested in what Car Sharing companies	DigiSure@59044
Damon Carr invested in what Banking companies	Data_Lake_Shore@69c3c
Cliff Holekamp invested in what Software companies	DealCloud@59c16|TopOPPS@752f5|BenchmarkONE@11659|Avail@ec259|Curate@a979f
Ed Walters invested in what Blockchain companies	Payourse@56e0a
Cliff Holekamp invested in what Sales companies	TopOPPS@752f5
Nicolaus Schefenacker invested in what Information and Communications Technology (ICT) companies	Sdui@ef0e7
Larisa Serova invested in what Brand Marketing companies	Befundo.com@39d49
Amin Chaar invested in what Internet companies	ecadema_-_Online_Learning@5848d
Qasar Younis invested in what Cloud Computing companies	blackshark.ai@a1772
Scott Belsky invested in what Public Transportation companies	Uber@bfcdc
Mario Letelier invested in what Lifestyle companies	Buscapé@40ab5
Michael Kleindl invested in what Advertising companies	Mediasmart@7d9c4
Ibrahim SOUA invested in what Manufacturing companies	Vectalys@aba98
Hunter Walk invested in what Internet companies	Assembly@6ac60
Faisal Yasin invested in what Blockchain companies	1ID@37388
Ira Lubert invested in what FinTech companies	Houwzer@8a9e3
Lawrence Lenihan invested in what Supply Chain Management companies	Resonance_Companies,_Inc.@0beca
Alex Ott invested in what FinTech companies	Squirro@f9f7a
Marcelo De Fuentes invested in what Lending companies	Fundary@bec04
Sumit Gupta invested in what Cryptocurrency companies	Experimental@2f2ee
Austen Allred invested in what Language Learning companies	Poliglota@1f1fc
Noam Kaiser invested in what SaaS companies	Vendia@46273
Sagar Ratilal Bavarva invested in what Renewable Energy companies	AASAN_SOLAR_POWER_LLP@fa910
Jason Calacanis invested in what Personal Health companies	StyleSeat@8d663
Dennis Weidner invested in what Autonomous Vehicles companies	ePilot_Mobility@0a622
Ariel Luedi invested in what Retail companies	Scandit@19ff6
David Zug invested in what Software companies	DigiSure@59044
Andrey Azarov invested in what EdTech companies	Laoshi@4eaa8
Shogo Kawada invested in what Software Engineering companies	Yappli@847c7
Mike Shim invested in what Software companies	DigiSure@59044
Carolyn Bivens invested in what Health Care companies	Quantason@d1bd7
John Ives invested in what FinTech companies	Compliable@c9aed
Josh Mailman invested in what Retail companies	Grove_Collaborative@9787a
