Thet Kyaw Linn invested in what companies based in Myanmar	Myanmar_Digital_Solutions@11e7f
Alejandro Revecco invested in what companies based in Chile	UHOMIE@d99de
Niklas Ostberg invested in what companies based in United Kingdom of Great Britain and Northern Ireland	Fresha@c7b4f
Richie Bello invested in what companies based in United States of America	Shop_Smart_Autos@b016a|Richie_Bello@482cb
Hermann Hauser invested in what companies based in Austria	Ease-Link_GmbH@3a273
Michael Altrichter invested in what companies based in Austria	App_Radar@10eb2
Kunal Shah invested in what companies based in India	HOGGY_(Litifer_Technologies_Pvt._Ltd.)@2b33d
Kevin Wall invested in what companies based in Finland	Kiosked@e3a2d
Noel Zeh invested in what companies based in Spain	Packlink@6e0f7
Jit Saxena invested in what companies based in United States of America	Wiser_Solutions@4c920
Rob McClatchey invested in what companies based in United Kingdom of Great Britain and Northern Ireland	Uniplaces@95738
Mika Salmi invested in what companies based in United States of America	Inkd.com@5f8ef
Jovan Hutton Pulitzer invested in what companies based in United States of America	Infotainment_Telepictures@d5130|Internet_America,_Inc.@89dcb
Pavel Glushenkov invested in what companies based in Russian Federation	CrowdSystems@9ede2|Level_Travel@5650f
Madis Müür invested in what companies based in Estonia	Ampler_Bikes@0eaf9
Brittney Mickel invested in what companies based in United States of America	Gain_Hash@bf48d|Jointer@7e1ea|Geoloqi@15f92
Hunter Walk invested in what companies based in United States of America	Assembly@6ac60
Oleg Krot invested in what companies based in United States of America	P2Pseller@af164
Jeff Weiner invested in what companies based in United States of America	Cloud_of_Goods@9567b
Dmitry Shapiro invested in what companies based in Sweden	iList@08c31
Uchechukwu Ajuzieogu invested in what companies based in United States of America	Foodhive@1dab0|LANFarms@fcee5|Ehubber@d66c6
Diane Harvey invested in what companies based in United States of America	133T.@5db8f
John Textor invested in what companies based in India	JesterDigital@df130
Murat Abdrakhmanov invested in what companies based in United States of America	Influ2@c8321
Chhang Bunthorn invested in what companies based in Cambodia	Music_Lover@60c72
Noam Kaiser invested in what companies based in United States of America	Vendia@46273
Cliff Holekamp invested in what companies based in United States of America	SoMoLend@a620f|DealCloud@59c16|FinLocker@23c31|Noonlight@d6a4b|BenchmarkONE@11659|Clever_Real_Estate@7e5bc|PlanGap@da7ee|TopOPPS@752f5|LockerDome@d8e15|Avail@ec259|Reconstruct@ec1c7|Curate@a979f
David Zug invested in what companies based in United States of America	DigiSure@59044
Jeffrey Cherry invested in what companies based in United States of America	Bodha_Inc@f70ae
Trevor Sumner invested in what companies based in United States of America	Myro@02a56
Ruth Johnston invested in what companies based in Ireland	MedPro_Billing_Solutions@1fd24
Jennifer Wyatt invested in what companies based in United States of America	GigWrks@02dc4
Mohsen Moazami invested in what companies based in United States of America	Peek@a0c53
Arul Murugan invested in what companies based in United States of America	Musicasa@99a5a
Sagar Ratilal Bavarva invested in what companies based in Netherlands	BeesDigitalFarm@da68d|HydraX_Incorporation@66e33
Robert Brill invested in what companies based in United States of America	eGifter@65f15
Romero Rodrigues invested in what companies based in Brazil	Buscapé@40ab5|Moneto@a8beb
Kevin Efrusy invested in what companies based in Brazil	Flash@fcd07
Pascal Levy-Garboua invested in what companies based in United States of America	Set_Labs@5e52e
Devdutt Yellurkar invested in what companies based in United States of America	Cratejoy@f1911
Carter Reum invested in what companies based in United States of America	5D_Holdings_LLC@2ecac
sachin kumar invested in what companies based in India	Taksh_it_solutions_pvt_ltd@7473a
Mark Cuban invested in what companies based in United States of America	BlueCava@ff8f8
Radu Georgescu invested in what companies based in United Kingdom of Great Britain and Northern Ireland	Vector_Watch@a2329
Michael Kleindl invested in what companies based in Spain	Mediasmart@7d9c4
Kevin Lin invested in what companies based in United States of America	Zaraz@110ae
Lawrence Lenihan invested in what companies based in United States of America	Resonance_Companies,_Inc.@0beca
Jay Minkoff invested in what companies based in United States of America	Houwzer@8a9e3
Jim Eberlin invested in what companies based in United States of America	Juristat@d8bcb
Bob Saunders invested in what companies based in United States of America	nQ_Medical@d8bb2
Roberto Nascimento invested in what companies based in Brazil	Kzas.AI@13303
Michael Marks invested in what companies based in United States of America	Trove@4afc9
Daniel O'Leary invested in what companies based in United States of America	Product_Revolution_Consulting@0b1ad
John Curtis invested in what companies based in Canada	Britcan_Media_Limited@42960
Julie Meyer invested in what companies based in Ireland	Lime&Tonic@18bf8
Todd Corenson invested in what companies based in United States of America	HelixNano@a5319
Abishek Sithampalam invested in what companies based in Sri Lanka	findmyfare.com@4c9cc
Altan Atabarut invested in what companies based in Turkey	Ulak@a6c26
Elena Perepelychnaya invested in what companies based in United States of America	Inserviss_Marketplace@a2148
Pettersom Paiva invested in what companies based in Spain	Super_Troupers@f52f5
L. Daniel Wilson invested in what companies based in Canada	Hölmetrics@3efcb
Amit Patni invested in what companies based in India	Wellness_Forever_Medicare@c5515
Kaare Danielsen invested in what companies based in Denmark	Firmafon@330ab
Tuncay TUNÇKOL invested in what companies based in United States of America	TUNÇKOL_MAKİNA@34ed2|TUNÇKOL@2ac7a|COOL_WATCH@a05c7
Robert Stavis invested in what companies based in United States of America	LNTS@8e98a
Jason Corsello invested in what companies based in United States of America	Assembly@6ac60
Harris Barton invested in what companies based in United States of America	Miles@69326
Jason Calacanis invested in what companies based in Ireland	AID:Tech@53d2c
Sumit Gupta invested in what companies based in Argentina	Experimental@2f2ee
Lisa Gansky invested in what companies based in United States of America	Trove@4afc9
Doug Chertok invested in what companies based in Chile	Poliglota@1f1fc
Qasar Younis invested in what companies based in Austria	blackshark.ai@a1772
Michael Gordon invested in what companies based in United States of America	Image_Space_Media@011ff
Morten Lund invested in what companies based in United States of America	Itembase@59603
Jerry Murdock invested in what companies based in United States of America	PayRange@331cb
Rohit Dalvi invested in what companies based in India	Infovys@d9862
Lou Kerner invested in what companies based in United States of America	Polar@3f532
Samuel Kwame Boadu invested in what companies based in Ghana	SamBoad_Express@b3131|SamBoad_Travel_and_Educational_Consult@ebe8a|SamBoad_Micro-Credit_Services@6e1fe
Eric Archambeau invested in what companies based in United States of America	SignalRank_Corporation@ff1ec
Austen Allred invested in what companies based in Chile	Poliglota@1f1fc
Ido Leffler invested in what companies based in United States of America	Omni@563a0
Immad Akhund invested in what companies based in United States of America	Lendflow@73c2c
Kai Hansen invested in what companies based in Germany	realxdata@2a0d0
Dan Scheinman invested in what companies based in United States of America	CyCognito@4cf38
Robin Vauvelle invested in what companies based in United Kingdom of Great Britain and Northern Ireland	Online_Shop@c29a3
David Murray-Hundley invested in what companies based in United Kingdom of Great Britain and Northern Ireland	e.fundamentals@4e706
Swamy Kotagiri invested in what companies based in United States of America	Tinychef@6c886
Kenzi Wang invested in what companies based in United States of America	Current_Mobile@f7769|MobileCoin@d37ac
Bruce A. Peacock invested in what companies based in United States of America	Interius_BioTherapeutics@52525
Ken Leonard invested in what companies based in United States of America	JoyFLIPS@ae138
NON-fungible Chan invested in what companies based in United States of America	Bling@cce01
Patrick Zeeuw invested in what companies based in United Kingdom of Great Britain and Northern Ireland	HIGH_PROFILE_CLUB@ba0f0
Saniya Shaikha invested in what companies based in India	Birbaboti@441bf
Mario Letelier invested in what companies based in Brazil	Buscapé@40ab5
Alex Lawton invested in what companies based in Spain	BEDROCK_-_Data_by_Design@3ad26
Cassio Jose Krupinsk invested in what companies based in Brazil	OXIBIZ@1eb16
Jason Calacanis invested in what companies based in United States of America	Ramen@e6c1d|BetterCompany@a8679|Coursalytics@77ada|ClosedWon@1ae70|Huckle@49472|Forge@16485|Blackthorn@23a75|Wrapify@52d44|Koloni@09d95|Desktop_Metal@adfc8|Mouth_Foods@65fa9|Betagig@2a332|Zembula@f10b4|Gigster@0e275|Whisper@7d6aa|Medium@35c41|tonebase@fab3f|Scout@4f420|Freeplay@f4d1f|REscour@5132f|Connect@7923e|axle_ai@46a57|Fresno_Unlimited@e120e|ScentBox@95394|Marlow@934b9|Bento@96989|Neyborly@49eba|LeadGenius@aa652|Blanket@053d2|Guardian_Circle@c5e5b|Stowaway_Cosmetics@05a65|Gather_Voices@0a508|ZenSports@939d4|CarForce@58b89|LÜK_Network@7e9b0|RushTix@20caa|StyleSeat@8d663|Zenefits@6d49d|Cozy@49ef4|Shoot_My_Travel@4b709|Flow_Laboratories@e4139|WhereBy.Us@e29e2|Ready@991c0|Scroll@02e1f|Cafe_X_Technologies@2f14d|Contraline@fc9c8|Crux@30281|TutorMe@11108|Passionflix@c5267|Density@9fce6|Shots_Studios@6e258|ToutApp@67161|Red_Tricycle@78154|CultureForce@448e1|Signpost@c134b|Captiv8@a1174|Momunt@12187|Talla@f7329|OneDrop@cd292|Chartbeat@fbdee|Little_Bird@a3866|Root_AI@c0a57|Blokable@8a1f3|Birdi@6ea2e|Butterfleye@aff70|Thalamus@0cb9c|Capsul_Jewelry@39357|Kush_Marketplace@259e4|The_Last_Guide_Company@8660d|Virgin_Hyperloop@54b88
Taavet Hinrikus invested in what companies based in United States of America	Pactum@16283
Ozi Amanat invested in what companies based in United States of America	Impossible_Foods@18b22|Coinbase@5eefb
Kaj Hed invested in what companies based in Finland	Kiosked@e3a2d
