Funding Round - DRACOON GmbH is launched in which city	Regensburg
Grant - MICA Biosystems is launched in which city	Birmingham
Angel Round - Skoller is launched in which city	Nashville
Series B - Array Networks is launched in which city	Milpitas
Seed Round - Voxon Photonics is launched in which city	Adelaide
Convertible Note - Pockit is launched in which city	London
Seed Round - Shape Matrix is launched in which city	Brooklyn
Series A - Boatjump is launched in which city	Valencia
Series B - igoxin.com is launched in which city	Changning
Venture Round - eNeura Therapeutics is launched in which city	Sunnyvale
Series C - Yunhaiyao is launched in which city	Fangshan
Series A - Enfuce is launched in which city	Espoo
Seed Round - Taembe.com is launched in which city	Singapore
Series A - Clearbit is launched in which city	San Francisco
Angel Round - FANTAWILD is launched in which city	Shenzhen
Series A - BIOAGE LABS is launched in which city	Richmond
Series D - InContext Solutions is launched in which city	Chicago
Grant - Saeco is launched in which city	Molina De Segura
Venture Round - Ocarina Networks is launched in which city	San Jose
Grant - Marquette University is launched in which city	Milwaukee
Seed Round - Flapper Technologies is launched in which city	Belo Horizonte
Convertible Note - DermaTrends is launched in which city	Minneapolis
Seed Round - eDossea is launched in which city	Cupertino
Venture Round - Best Buds is launched in which city	Puerto Rico
Seed Round - Ulysses is launched in which city	Tokyo
Venture Round - EndoChoice is launched in which city	Alpharetta
Seed Round - Prevailion is launched in which city	Fulton
Venture Round - StartSampling is launched in which city	Carol Stream
Series F - Revenue Technologies is launched in which city	Atlanta
Pre Seed Round - Kaiku is launched in which city	London
Angel Round - HOZ Medical is launched in which city	Beijing
Seed Round - Amsel Medical Corp is launched in which city	Cambridge
Pre Seed Round - AutoPlus is launched in which city	Tunis
Seed Round - Lucinity is launched in which city	Reykjavík
Venture Round - SkyCell is launched in which city	Zürich
Series C - Lukka is launched in which city	New York
Venture Round - XCOR Aerospace is launched in which city	Mojave
Venture Round - Maples ESM Technologies is launched in which city	Somerset
Funding Round - Jjhgame is launched in which city	Jinhua
Private Equity Round - MedHOK is launched in which city	Tampa
Venture Round - AÉRYNE is launched in which city	Paris
Seed Round - Scoopr Media is launched in which city	Boston
Post-IPO Equity - Artelo Biosciences is launched in which city	La Jolla
Series F - JumpCloud is launched in which city	Louisville
Series B - Lightpoint Medical is launched in which city	Chesham
Series D - CyVek is launched in which city	Wallingford
Grant - Linked Finance is launched in which city	Dublin
Pre Seed Round - EATLAB is launched in which city	Bangkok
Seed Round - EnzBond is launched in which city	Oxford
Series E - Opendoor is launched in which city	San Francisco
Series A - Tibber is launched in which city	Førde
Debt Financing - Crunch Data is launched in which city	Denver
Seed Round - MedCrypt is launched in which city	Encinitas
Series A - Edicia is launched in which city	Carquefou
Seed Round - Chartmetric is launched in which city	Palo Alto
Post-IPO Equity - Silence Therapeutics is launched in which city	London
Seed Round - Like a Local is launched in which city	Tallinn
Venture Round - Good Day Chocolate is launched in which city	Boulder
Seed Round - BEC Inc. is launched in which city	Tokyo
Seed Round - Heppee is launched in which city	Amsterdam
Grant - Eltechs is launched in which city	Moscow
Venture Round - SiteBrand is launched in which city	Gatineau
Pre Seed Round - Antidote Health is launched in which city	New York
Seed Round - TOMORROW Super is launched in which city	Chippendale
Seed Round - Nerdstudy is launched in which city	Toronto
Series E - Aquantia is launched in which city	Milpitas
Grant - Placer Community Foundation is launched in which city	Auburn
Series D - Cashify is launched in which city	Gurgaon
Venture Round - Rockit Apples is launched in which city	Havelock North
Venture Round - Tachyon Networks is launched in which city	San Diego
Convertible Note - GrowJourney is launched in which city	Greenville
Seed Round - Detective is launched in which city	Chicago
Series A - DHgames is launched in which city	Chengdu
Series A - Metek is launched in which city	Shanghai
Pre Seed Round - Bookshop is launched in which city	Brooklyn
Grant - NeuroTechR3 is launched in which city	Newark
Venture Round - Cleveland Diagnostics is launched in which city	Cleveland
Venture Round - Leosphere is launched in which city	Orsay
Venture Round - ProCure Treatment Centers is launched in which city	New York
Post-IPO Equity - Roka Bioscience is launched in which city	Warren
Seed Round - Gongye Technology is launched in which city	Dongguang
Seed Round - ByteActive is launched in which city	Stockholm
Pre Seed Round - Gmelius is launched in which city	Geneva
Venture Round - Pinger is launched in which city	San Jose
Pre Seed Round - NAZAR is launched in which city	Pernambuco
Post-IPO Equity - i-80 Gold is launched in which city	Reno
Post-IPO Equity - International Stem Cell Corporation is launched in which city	Carlsbad
Series A - NEGOS is launched in which city	Palo Alto
Grant - Quotanda is launched in which city	Mexico City
Venture Round - AKQA is launched in which city	London
Grant - Mito Material Solutions is launched in which city	Stillwater
Venture Round - In2cure is launched in which city	Lund
Seed Round - Verimatrix is launched in which city	San Diego
Venture Round - TECOTEC is launched in which city	Tokyo
Venture Round - Century Insurance Brokers is launched in which city	Beijing
Grant - BrainPort Technologies is launched in which city	Middleton
Grant - Feasible is launched in which city	Emeryville
Corporate Round - Fuller is launched in which city	Chiba
Seed Round - WiseWear is launched in which city	San Antonio
Seed Round - Brandfitters is launched in which city	Dallas
