list the companies who are lead investors of Debt Financing - True Velocity Ammunition	Auctus_Capital_Partners@198c1
list the companies who are lead investors of Grant - Kite Solutions	EASME_-_EU_Executive_Agency_for_SMEs@5d877
list the companies who are lead investors of Private Equity Round - IntelliRisk Management	Harvest_Partners@d0a75
list the companies who are lead investors of Series B - SurvivorNet	Gartmore_Investment_Management@709fa
list the companies who are lead investors of Series D - DispatchHealth	Tiger_Global_Management@0a837
list the companies who are lead investors of Venture Round - Veloxia Technology	Collective_Spark@58143
list the companies who are lead investors of Series D - MicroVention Terumo	U.S._Venture_Partners@7d726
list the companies who are lead investors of Seed Round - FAIRMAT	Singular@540fc
list the companies who are lead investors of Grant - Trackwell	Technology_Development_Fund@18f20
list the companies who are lead investors of Venture Round - Shubham Housing Development Finance Company	PremjiInvest@d666e
list the companies who are lead investors of Seed Round - Micron AgriTech	Enterprise_Ireland@c23b6
list the companies who are lead investors of Private Equity Round - BYJU’S	Tiger_Global_Management@0a837
list the companies who are lead investors of Corporate Round - Liquid	KDDI@a7ed8
list the companies who are lead investors of Equity Crowdfunding - EqSeed	EqSeed@7bb60
list the companies who are lead investors of Grant - InDex Pharmaceuticals	Vinnova@dd507
list the companies who are lead investors of Series B - Qyer.com	Alibaba_Capital_Partners@6bbbd
list the companies who are lead investors of Series B - Pitzi	Thrive_Capital@f41ab
list the companies who are lead investors of Venture Round - Prolacta Bioscience	Essex_Woodlands_Healthcare_Partners@3bdea
list the companies who are lead investors of Seed Round - Buddy Technologies	Transmedia_Capital@52e9a
list the companies who are lead investors of Grant - vencortex®	Wirtschafts-_und_Infrastrukturbank_Hessen@71a02
list the companies who are lead investors of Series B - Adents	CapHorn_Invest@ebf62
list the companies who are lead investors of Grant - Vekta Innovations	Technology_Innovation_Agency@d3965
list the companies who are lead investors of Grant - Boston Geospatial	NGA_Accelerator@065ff
list the companies who are lead investors of Seed Round - MEDcraze	JG_Griffeth_Investments@0d378
list the companies who are lead investors of Corporate Round - VIDA	UnityPoint_Health_Ventures@984cf
list the companies who are lead investors of Grant - RigiTech	Venture_Kick@95916
list the companies who are lead investors of Series A - XDEFI Wallet	Mechanism_Capital@f741f
list the companies who are lead investors of Seed Round - Mintifi	Lok_Capital@8a36e
list the companies who are lead investors of Venture Round - TARIS Biomedical	Flagship_Pioneering@fe151
list the companies who are lead investors of Seed Round - Terakalis	Aster@4234a
list the companies who are lead investors of Series A - Qogita	Accel@7bf36
list the companies who are lead investors of Series B - Esperanto Technologies	Almaz_Capital@d5a7d
list the companies who are lead investors of Series A - Schoology	Meakem_Becker_Venture_Capital@5165a
list the companies who are lead investors of Series B - ANGARA DeCarbonX	Foxtail_Investment@3b712
list the companies who are lead investors of Series D - Nutmeg	Taipei_Fubon_Bank@5b42a
list the companies who are lead investors of Venture Round - MultiLiving	Lodha_Ventures@ee247
list the companies who are lead investors of Angel Round - Lyncon	CAS_Star@23da0
list the companies who are lead investors of Seed Round - Zhizhangyi	Lightspeed_China_Partners@d3391
list the companies who are lead investors of Series A - Here Holdings	Listen@7cf95
list the companies who are lead investors of Grant - Softhread	National_Science_Foundation@583cb
list the companies who are lead investors of Seed Round - iconicchain	Business_Finland@a6540
list the companies who are lead investors of Venture Round - Talyst	ORIX_Ventures@8ef01
list the companies who are lead investors of Series A - Ulucu	Kleiner_Perkins@421ec
list the companies who are lead investors of Grant - NewGrid	Massachusetts_Clean_Energy_Center@beff3
list the companies who are lead investors of Venture Round - Urb-IT	Swedbank_Robur@8cd28
list the companies who are lead investors of Seed Round - GetJenny	Dubai_Angel_Investors@2ae6b
list the companies who are lead investors of Corporate Round - MerryBiz	Fuyo_General_Lease@0385c
list the companies who are lead investors of Seed Round - iMetaFilm	Kelvin_Capital@71582
list the companies who are lead investors of Series C - Bluefire Security Technologies	Grotech_Ventures@bb596
list the companies who are lead investors of Series A - GigaIO	Mark_IV_Capital@4810c
list the companies who are lead investors of Seed Round - Bulky	BASF@19904
list the companies who are lead investors of Series A - Ennoventure	Fenice_Investment_Group@ffa31
list the companies who are lead investors of Series A - Beef Butcher	Infoview_Technology@94068
list the companies who are lead investors of Seed Round - trippiece	MOVIDA_JAPAN@84c00
list the companies who are lead investors of Series A - Boatjump	Capitana_Venture_Partners@6ee66
list the companies who are lead investors of Private Equity Round - Apex International Energy	International_Finance_Corporation@9d72e
list the companies who are lead investors of Series B - Arkin	Nexus_Venture_Partners@7bdd1
list the companies who are lead investors of Seed Round - AdaptiLab	Trilogy_Equity_Partners@9e8a4
list the companies who are lead investors of Seed Round - The Qube	ACF_Investors@3b2f2
list the companies who are lead investors of Series A - Mobiquity	Longworth_Venture_Partners@aca70
list the companies who are lead investors of Debt Financing - Al Hamra Real Estate Development	Goldman_Sachs@fc86c
list the companies who are lead investors of Pre Seed Round - Fiveable	gener8tor@c065d
list the companies who are lead investors of Series B - CloudHealth Technologies	Scale_Venture_Partners@3c6b2
list the companies who are lead investors of Series A - Xiaoxin Tong	AceBridge@bc2db
list the companies who are lead investors of Grant - Acute Technology	SBRI_Healthcare@d5ede
list the companies who are lead investors of Series A - Intelligent Power Generation	consortium@65a65
list the companies who are lead investors of Seed Round - PlanetWatch	RA.MO@b7eb8
list the companies who are lead investors of Series A - A Cloud Guru	Elephant@6be19
list the companies who are lead investors of Series A - Centripetal Networks	Option3Ventures@d5712
list the companies who are lead investors of Private Equity Round - DNEG	Novator@acda5
list the companies who are lead investors of Pre Seed Round - Releaf	Y_Combinator@d2d5e
list the companies who are lead investors of Series A - Craft	Creandum@34433
list the companies who are lead investors of Seed Round - Opencasa.com	Manutara_Ventures@fb439
list the companies who are lead investors of Debt Financing - ecoRobotix	Foundation_for_Technological_Innovation_(FIT)@a7107
list the companies who are lead investors of Series A - RtTech Software	McRock_Capital@4414f
list the companies who are lead investors of Seed Round - AOA	Joyance_Partners@14c14
list the companies who are lead investors of Post-IPO Equity - MariMed	Navy_Capital@f06af
list the companies who are lead investors of Series A - Flock Safety	Bedrock_Capital@35cee
list the companies who are lead investors of Grant - Matorka	Technology_Development_Fund@18f20
list the companies who are lead investors of Pre Seed Round - Adaptricity	Venture_Kick@95916
list the companies who are lead investors of Venture Round - Kit for Kids	Connection_Capital@d3771
list the companies who are lead investors of Series B - Digby	Relay_Ventures@93615
list the companies who are lead investors of Series A - Usermind	Andreessen_Horowitz@5ca29
list the companies who are lead investors of Series B - Jingzhengu.com	Bitauto_Holdings@37cda
list the companies who are lead investors of Series D - Antiva Biosciences	Adjuvant_Capital@47f84
list the companies who are lead investors of Series B - TopSchool	Pritzker_Group_Venture_Capital@dc298
list the companies who are lead investors of Seed Round - Clementine App	Fortunis_Capital@5d266
list the companies who are lead investors of Debt Financing - VGN Property Developers	Edelweiss_Financial_Services@4c343
list the companies who are lead investors of Seed Round - AmiKana.BioLogics	Paca_Investissement@1bfe1
list the companies who are lead investors of Venture Round - Hive Online	Encore_Capital@49816
list the companies who are lead investors of Series D - VRChat	Anthos_Capital@05779
list the companies who are lead investors of Series A - JHNYH.com	Galaxy_Capital@091cc
list the companies who are lead investors of Seed Round - Tawfeer Market	Alex_Angels@6af5a
list the companies who are lead investors of Equity Crowdfunding - Housers	Crowdcube@f2e80
list the companies who are lead investors of Seed Round - framebunker	Goodbye_Kansas_Game_Invest@54270
list the companies who are lead investors of Seed Round - Zencity	Canaan_Partners_Israel@8b901
list the companies who are lead investors of Convertible Note - Biomedican	HNI@99f00
list the companies who are lead investors of Series A - Snapdocs	Sequoia_Capital@55f91
list the companies who are lead investors of Venture Round - Powertherm Contract Services	NPIF–Mercia_Debt_Finance@a9cf1
list the companies who are lead investors of Seed Round - Infratop	East_Ventures@6425e
