Andy Goldstein invested in which funding rounds	Seed_Round_-_CRUX_Knowledge@6bee0
Elon Jobs invested in which funding rounds	Pre_Seed_Round_-_Kitcart@127f1
David Nothacker invested in which funding rounds	Series_A_-_Sdui@4e289
Sky Dayton invested in which funding rounds	Angel_Round_-_Diffbot@457ec|Seed_Round_-_Pipe@df72b
Pettersom Paiva invested in which funding rounds	Pre_Seed_Round_-_Super_Troupers@30dd5
Austen Allred invested in which funding rounds	Seed_Round_-_Poliglota@9b6ac
John Textor invested in which funding rounds	Series_B_-_JesterDigital@e7049
Jerry Murdock invested in which funding rounds	Series_A_-_PayRange@9664a|Convertible_Note_-_PayRange@90c09|Seed_Round_-_PayRange@47dcd|Venture_Round_-_PayRange@3fb1c
Ira Lubert invested in which funding rounds	Seed_Round_-_Houwzer@abc4e|Series_A_-_Houwzer@e36d9
Adil Saleh invested in which funding rounds	Angel_Round_-_CardClan@a8b8d
Yahya Ülker invested in which funding rounds	Venture_Round_-_Istegelsin@8f23c
Jenny Lefcourt invested in which funding rounds	Seed_Round_-_Inspectiv@67622|Series_A_-_Daily.co@f2998|Series_B_-_Daily.co@fa273|Seed_Round_-_Daily.co@fc850|Seed_Round_-_Well_Health@9654c|Seed_Round_-_BetterUp@38aa9
Ozi Amanat invested in which funding rounds	Series_E_-_Impossible_Foods@12bd9|Venture_Round_-_Oatly@6b25b|Series_E_-_Coinbase@b04f9
Kevin Lin invested in which funding rounds	Seed_Round_-_Zaraz@5c56d
Lou Kerner invested in which funding rounds	Funding_Round_-_Polar@ef2ed
Alexander Edward Chesterman invested in which funding rounds	Seed_Round_-_Uniplaces@b3ae9|Pre_Seed_Round_-_trustshare@a731b
Jim Payne invested in which funding rounds	Pre_Seed_Round_-_FirstCut@8364c
Dan Levitan invested in which funding rounds	Series_B_-_Trove@a858a
Nemer Rahal invested in which funding rounds	Pre_Seed_Round_-_Sami@8b05a
Monish Darda invested in which funding rounds	Seed_Round_-_TurboHire_Technologies@64866
Rajesh Sawhney invested in which funding rounds	Convertible_Note_-_HOGGY_(Litifer_Technologies_Pvt._Ltd.)@690bf
Richie Bello invested in which funding rounds	Seed_Round_-_Richie_Bello@eef98|Seed_Round_-_Shop_Smart_Autos@819a7
Jovan Hutton Pulitzer invested in which funding rounds	Pre_Seed_Round_-_Internet_America,_Inc.@aab14|Seed_Round_-_Infotainment_Telepictures@4e763
Aminur Rashid invested in which funding rounds	Seed_Round_-_Pickaboo.com@14714|Seed_Round_-_Pickaboo.com@0f0f7
Jim Eberlin invested in which funding rounds	Seed_Round_-_Juristat@d7a63
Rohit Dalvi invested in which funding rounds	Private_Equity_Round_-_Infovys@46acf
Joshua Browder invested in which funding rounds	Pre_Seed_Round_-_Wander@1569d
Gilles Blanchard invested in which funding rounds	Pre_Seed_Round_-_doc-doc@983f2
Bruce A. Peacock invested in which funding rounds	Venture_Round_-_Interius_BioTherapeutics@525ac
Francisco Arcilla invested in which funding rounds	Seed_Round_-_TurboHire_Technologies@64866
Marek Olszewski invested in which funding rounds	Pre_Seed_Round_-_Payourse@3c05f
Dirk Freise invested in which funding rounds	Seed_Round_-_Sdui@7346f|Series_A_-_Sdui@4e289
John Curtis invested in which funding rounds	Seed_Round_-_Britcan_Media_Limited@13c58
Steen Ulf Jensen invested in which funding rounds	Pre_Seed_Round_-_Cavea@fcf78
Jenny Rooke invested in which funding rounds	Seed_Round_-_Zymergen@f8e82|Seed_Round_-_Zephyrus_Biosciences@66943
Ariel Luedi invested in which funding rounds	Angel_Round_-_Scandit@b0acf
Heidi Patel invested in which funding rounds	Seed_Round_-_KETOS@20218
Cliff Holekamp invested in which funding rounds	Series_B_-_LockerDome@8fdf1|Series_A_-_FinLocker@4c2d4|Series_B_-_Clever_Real_Estate@c72ab|Seed_Round_-_Noonlight@5b410|Series_A_-_PlanGap@28980|Seed_Round_-_Curate@d6c3b|Convertible_Note_-_FinLocker@af2e7|Seed_Round_-_SoMoLend@59069|Seed_Round_-_BenchmarkONE@b59d2|Seed_Round_-_Curate@90e67|Series_A_-_Avail@f9282|Seed_Round_-_BenchmarkONE@8a012|Series_A_-_LockerDome@0e005|Series_A_-_Reconstruct@797af|Venture_Round_-_Avail@bf0a3|Seed_Round_-_TopOPPS@4aaf0|Series_A_-_Clever_Real_Estate@f5f4f|Series_A_-_DealCloud@9e32b|Seed_Round_-_TopOPPS@f21d1
Joe Jaramillo invested in which funding rounds	Seed_Round_-_TIG_Investments_LLC@7aeb0
Igor Tikhturov invested in which funding rounds	Pre_Seed_Round_-_HolidayFox@0ad1e
Arul Murugan invested in which funding rounds	Pre_Seed_Round_-_Musicasa@9faf8
Sebastian Brunemeier invested in which funding rounds	Seed_Round_-_Cyclone_Therapeutics@6669d
Julius Koehler invested in which funding rounds	Series_A_-_Sdui@4e289
NON-fungible Chan invested in which funding rounds	Pre_Seed_Round_-_Bling@1acbf
Yongjie Yao invested in which funding rounds	Venture_Round_-_Enjoyor@be0af
Luis Cesar Verdi invested in which funding rounds	Seed_Round_-_Inventsys_DESKO@6516b
Qasar Younis invested in which funding rounds	Series_A_-_blackshark.ai@7fe41
Daren Trousdell invested in which funding rounds	Pre_Seed_Round_-_Clip_Money_Inc.@f6fc7
Sandy Purcell invested in which funding rounds	Post-IPO_Equity_-_AudioEye@de6a3
Michael Maximilian Sepp invested in which funding rounds	Pre_Seed_Round_-_Befundo.com@8d228|Series_B_-_Befundo.com@2f724
Klaas Kersting invested in which funding rounds	Pre_Seed_Round_-_GYANT@8723c
Dennis Weidner invested in which funding rounds	Pre_Seed_Round_-_ePilot_Mobility@b848e
Franciscus Zheng invested in which funding rounds	Pre_Seed_Round_-_PopIt_Snack@50b98
Damon Carr invested in which funding rounds	Seed_Round_-_Data_Lake_Shore@5389c
lLammar Perfect invested in which funding rounds	Pre_Seed_Round_-_Ammar_Lexie@c860a
Miranda Son invested in which funding rounds	Pre_Seed_Round_-_Quantx_Technologies@8653f
Mehrdad Piroozram invested in which funding rounds	Seed_Round_-_Golf_Post_AG@a5655
Erik Ford invested in which funding rounds	Seed_Round_-_Set_Labs@ba81d
Shaquille O'Neal invested in which funding rounds	Venture_Round_-_FORTO_Coffee_Shots@554d4
Jennifer Wyatt invested in which funding rounds	Pre_Seed_Round_-_GigWrks@083f0
Calvin Ayre invested in which funding rounds	Seed_Round_-_TonicPow@f5f27
Ishara Yusdian invested in which funding rounds	Debt_Financing_-_Gayo_Capital@14e1e|Convertible_Note_-_PasarMIKRO@9f90c|Debt_Financing_-_Gayo_Capital@ec414|Debt_Financing_-_Gayo_Capital@9aa8b|Funding_Round_-_Gayo_Capital@be574|Seed_Round_-_Foom@cf1f1|Debt_Financing_-_Gayo_Capital@65e0f
Samuel Kwame Boadu invested in which funding rounds	Seed_Round_-_SamBoad_Travel_and_Educational_Consult@e7d16|Series_A_-_SamBoad_Express@f0650|Seed_Round_-_SamBoad_Micro-Credit_Services@3fdfc
Richard Branson invested in which funding rounds	Seed_Round_-_Tens@f0b36
Phin Upham invested in which funding rounds	Seed_Round_-_PayZen@8ef4b
Tomer Tagrin invested in which funding rounds	Series_B_-_Anyword@5bda1
Jonathan Boutelle invested in which funding rounds	Seed_Round_-_GeneDrop@e27d9
Udo Schloemer invested in which funding rounds	Seed_Round_-_Sdui@7346f|Series_A_-_Sdui@4e289
Fabio Rosati invested in which funding rounds	Seed_Round_-_DigiSure@b0706
Lynn-Ann Gries invested in which funding rounds	Pre_Seed_Round_-_OndeCare@6e51b
Jazeer Jamal invested in which funding rounds	Pre_Seed_Round_-_GrowValley@be9bb|Seed_Round_-_GrowValley@913ff|Seed_Round_-_GrowValley@0001c
Alex Lawton invested in which funding rounds	Debt_Financing_-_BEDROCK_-_Data_by_Design@abe6c
Betsalel Elfassy invested in which funding rounds	Funding_Round_-_Brands_Capital@e2419
Kaare Danielsen invested in which funding rounds	Angel_Round_-_Firmafon@85a1e
Ullas Naik invested in which funding rounds	Series_A_-_Vise@d9d10
Brian Craig invested in which funding rounds	Seed_Round_-_Nanoprecise_Sci_Corp@37f53
P. Addo-Nyarko invested in which funding rounds	Series_A_-_PISTIS_And_Associates@11bd6
Markus Frind invested in which funding rounds	Seed_Round_-_Tastry,_Inc.@b522b
Oleg Krot invested in which funding rounds	Seed_Round_-_P2Pseller@9b0ab
Yura Lazebnikov invested in which funding rounds	Seed_Round_-_P2Pseller@9b0ab
Scott Banister invested in which funding rounds	Series_A_-_Dyspatch@6cef3
Yasmin Shahin Shaikh invested in which funding rounds	Pre_Seed_Round_-_YAS@6fa80
Igal Weinstein invested in which funding rounds	Series_A_-_Inception_XR@759ea|Seed_Round_-_HAAT_Delivery@4ebe7|Seed_Round_-_JSonar@89a55
Ibrahim SOUA invested in which funding rounds	Seed_Round_-_Vectalys@bc349
Julien Machot invested in which funding rounds	Seed_Round_-_NITRO_Beverage@5a405|Pre_Seed_Round_-_ISDC@93cc4
Simon Slamka invested in which funding rounds	Funding_Round_-_Ongakken@04c06
Ido Leffler invested in which funding rounds	Seed_Round_-_Omni@4b1ba
Luzius Meisser invested in which funding rounds	Pre_Seed_Round_-_Timber_Base@4cc0a
Kai Hansen invested in which funding rounds	Pre_Seed_Round_-_realxdata@3e043
Samir Khosla invested in which funding rounds	Seed_Round_-_TurboHire_Technologies@64866
Thu Nguyen Thi invested in which funding rounds	Seed_Round_-_HTK_SHIPPING_AND_IMPORT_EXPORT_CO.,LTD@63c0e|Corporate_Round_-_NCC_Asia_Plus_Vietnam@03e3d
Glen Kacher invested in which funding rounds	Seed_Round_-_SignalRank_Corporation@0d50f
Uchechukwu Ajuzieogu invested in which funding rounds	Pre_Seed_Round_-_Foodhive@e29d0|Pre_Seed_Round_-_Ehubber@370e2|Seed_Round_-_Foodhive@9f344|Pre_Seed_Round_-_LANFarms@c75b9
Aamir Rehman invested in which funding rounds	Pre_Seed_Round_-_Defynance@477de
David Zug invested in which funding rounds	Seed_Round_-_DigiSure@b0706
Michael Gordon invested in which funding rounds	Series_A_-_Image_Space_Media@704a7
Madis Müür invested in which funding rounds	Equity_Crowdfunding_-_Ampler_Bikes@70c3b
Chhang Bunthorn invested in which funding rounds	Pre_Seed_Round_-_Music_Lover@73a3c
Denis Lafont-Trevisan invested in which funding rounds	Pre_Seed_Round_-_Caption@bf56d
Carter Reum invested in which funding rounds	Series_A_-_5D_Holdings_LLC@f346b
