list the investment partners of Non Equity Assistance - InnerHour	Paul_Ravindranath@55557
list the investment partners of Grant - Zonie's Closet	Tedd_Grain@8d2ab
list the investment partners of Grant - Nonspec	Kiki_Mills_Johnston@0c255
list the investment partners of Seed Round - Solvvy	Bobby_Yazdani@32d85
list the investment partners of Seed Round - Corvus Insurance	Matt_Harris@3dc47
list the investment partners of Series A - Age of Learning	Will_Griffith@85580
list the investment partners of Pre Seed Round - Klaus	Aleksi_Partanen@e4538
list the investment partners of Series A - VMLogix	Ajay_Agarwal@efccc
list the investment partners of Venture Round - Demecan	Shahin_Dashti@8d999
list the investment partners of Venture Round - Market Realist	Justin_Brownhill@a5a81|Peter_Kellner@b6e36
list the investment partners of Non Equity Assistance - MIFCOR	Israel_Ganot@91c2d
list the investment partners of Series D - Daktari Diagnostics	Roger_Kitterman@4af54|Aaron_Sandoski@2caf3|David_M._Rubin@40f6a
list the investment partners of Series A - Theranica	Yoni_Cheifetz@07f9b
list the investment partners of Seed Round - Mixed Dimensions	Gilman_Louie@f7f57
list the investment partners of Private Equity Round - Hairstory	Melanie_Whelan@954e9
list the investment partners of Seed Round - HETIKUS	Ignacio_Fonts@3136e|Angel_Bou@e3a3f
list the investment partners of Venture Round - OrthoAccel Technologies	Paul_Pryzant@e21c1|David_Steakley@3eda7
list the investment partners of Venture Round - Cheddar Up	Alex_Soffe@b39bf
list the investment partners of Private Equity Round - 3E	Stephen_King@04d6b
list the investment partners of Private Equity Round - Rectangle Health	Roy_Burns@8917d
list the investment partners of Venture Round - Fleetworthy Solutions	Daniel_Raynor@a9845|Jim_Macdonald@2633c
list the investment partners of Seed Round - Krowder	Alireza_Masrour@71464
list the investment partners of Seed Round - Plumzi	Ben_Capell@93e6b
list the investment partners of Series A - Wintermute Trading	Jeremy_Liew@958eb
list the investment partners of Seed Round - Pico	Charles_Hudson@67757
list the investment partners of Series D - Tractable	Emily_Walsh@9a3b2|Lonne_Jaffe@df618
list the investment partners of Series E - Spiceworks	Ravi_Mohan@63e8b|David_Campbell@6c370|Jeffrey_Diehl@89793|Steve_Harrick@a7bd4
list the investment partners of Series A - Ketch	Izhar_Armony@92e6b|Theresia_Gouw@55c80
list the investment partners of Seed Round - Groupee	Trevor_Folsom@ef34c
list the investment partners of Series A - SOASTA	John_Balen@2c02d
list the investment partners of Private Equity Round - Syndigo	Peter_L._Rottier@6fb64
list the investment partners of Series B - New Forests	Zebediah_Rice@8630d
list the investment partners of Convertible Note - Crossing Minds	Alireza_Masrour@71464
list the investment partners of Series A - Alsid	Alexandre_Mordacq@7d22e|Jonathan_Userovici@aa98a|Mathieu_Viallard@07147
list the investment partners of Seed Round - Andiamo	Bartosz_Lipnicki@9e0b5|Jonathan_Synett@dec58
list the investment partners of Series A - Dealroom.co	Ronald_van_der_Heide@710be
list the investment partners of Seed Round - Stampli	Bobby_Lent@12b09|James_Cham@e626e
list the investment partners of Series A - Molecula	Andy_Jenks@e9a07
list the investment partners of Convertible Note - Sundial Foods	Po_Bronson@9a613
list the investment partners of Venture Round - Flywheel	Gary_Dillabough@0128d|Sam_Fort@3d3d0
list the investment partners of Seed Round - Assert	Suresh_Narasimha@c057f
list the investment partners of Series B - InviteManager	Nathan_Locke@d88f1|David_Martirano@869a9|Sean_Marsh@09941
list the investment partners of Seed Round - ContextPlane	Keith_Teare@a04e1
list the investment partners of Convertible Note - Slang	Fernando_Lelo_de_Larrea@fe88f|Gregorio_Marquez@8a7a9
list the investment partners of Seed Round - Zeus Living	Michael_Brown@ad566
list the investment partners of Venture Round - NetScreen Technologies	Yan_Ke@6b335|Feng_Deng@0c86b
list the investment partners of Series B - Linktree	Dan_Rose@d3023|Danny_Rimer@32a73|John_Henderson@2babc|Jeff_Lieberman@5f360
list the investment partners of Pre Seed Round - Arete	Todd_Deacon@cb9fe
list the investment partners of Convertible Note - Unety	Mark_Paris@3f9b4
list the investment partners of Series A - HubLogix	John_Mandile@e502a
list the investment partners of Series A - Miles	Oliver_Frenz@60bf6|Ryan_Mendoza@836bb
list the investment partners of Venture Round - Deepgram	George_Hoyem@c2b9a
list the investment partners of Series B - Strata Oncology	Bill_Burkoth@044ea
list the investment partners of Series A - WeShine	Hurst_Lin@5c573
list the investment partners of Grant - The Quarry Burn	Sarah_Slaven@d89fd|Carl_Marshall@054dd
list the investment partners of Series A - Altheos	Peter_Bisgaard@b7ffb|Wende_Hutton@41ffe
list the investment partners of Funding Round - Actual Experience	Mark_Reilly@114e1
list the investment partners of Series A - ApplePie Capital	Zaw_Thet@697e7
list the investment partners of Series A - XtremIO	Eyal_Niv@d15f4
list the investment partners of Grant - Vena Medical	Chamath_Palihapitiya@5e8eb|Brigette_Lau@84dfc
list the investment partners of Pre Seed Round - Induction Food Systems	Brett_Brohl@a1d4d
list the investment partners of Series B - Copia Global	Els_Boerhof@fa6cc
list the investment partners of Series B - Everlaw	Tyler_Sosin@63b36|Steven_Sinofsky@490ef
list the investment partners of Series B - FairMoney	Ameya_Upadhyay@0e1a3|Scott_Shleifer@701fb|Guzel_Gumerova@cf741|Augustin_Sayer@b2831
list the investment partners of Series A - Conita Technologies	Douglas_Schrier@536c4
list the investment partners of Series A - Vention	Ajay_Agarwal@efccc|Sylvain_Carle@89c06
list the investment partners of Seed Round - Nurix Therapeutics	David_Goeddel@db8e4
list the investment partners of Series B - Cara Therapeutics	Geoffrey_W._Smith@734f3
list the investment partners of Private Equity Round - Lux Research Inc.	Pavan_Tripathi@0a6bc|Daniel_Kim@6d7c1
list the investment partners of Convertible Note - MNTN	Dana_Settle@acba2
list the investment partners of Series B - Akebia Therapeutics	Campbell_Murray@72c33|John_M._Rice@0efb8|Paul_Weiss@9e606
list the investment partners of Series D - CardioMEMS	Francisco_Garcia@c6a83
list the investment partners of Series B - Billetto	Kjartan_Rist@f91a0
list the investment partners of Venture Round - Breaker	Hironao_Kunimitsu@f6021|Shigeo_Maruyama@184fe
list the investment partners of Private Equity Round - Drillinginfo	Nimay_Mehta@f6a12|Jesse_Feldman@e535f|Hilary_Gosher@f3e41|Mitchell_Green@abcc8
list the investment partners of Seed Round - Birdie	Guillaume_Borie@f3261
list the investment partners of Seed Round - Primary	Satya_Patel@4392a|Michael_Dearing@bd867
list the investment partners of Seed Round - Windborne	Sven_Strohband@1e43a
list the investment partners of Venture Round - Jupiter Group	Arne_Handeland@da2e1|Max_Carls√©n@e89e9|Emanuel_Johnsson@fe32b|Pal_Malmros@7df59
list the investment partners of Non Equity Assistance - Skydropx	Santosh_Sankar@79788
list the investment partners of Series D - ElasticRun	Ashutosh_Sharma@49e0d|Mohan_Kumar@71bed
list the investment partners of Series A - Bolttech	Kwan_Yoon@bdaf0
list the investment partners of Series C - Reconnex	Vivek_Mehra@be4ad|Matthew_Howard@58b92
list the investment partners of Series A - Replimune Group	Jason_Rhodes@5bdca
list the investment partners of Series C - Workiz	Aaron_Rosenson@ca740|Ran_Levitzky@e1fed|Avery_Rosin@a42e2
list the investment partners of Pre Seed Round - Kikstylist	Zach_Ferres@35877
list the investment partners of Venture Round - edozo	Edward_Rudd@b171e|Reuben_Wilcock@93e42
list the investment partners of Seed Round - Parabeac	Beto_Pallares@fac53
list the investment partners of Seed Round - Mighty AI	Brad_Feld@db498
list the investment partners of Series B - CoWare	Dave_Strohm@7820b
list the investment partners of Venture Round - Nexosis	Ryan_Broshar@c4d35|Ryan_Helon@220f7
list the investment partners of Series A - Lytics	Scott_Irwin@32a7e|Andrew_Cleland@61037|Erik_Benson@8bc32
list the investment partners of Seed Round - Ambire	Todor_Breshkov@51933
list the investment partners of Series B - YottaMark	Chris_Hollenbeck@3c098|Don_Butler@46fcb|Hatch_Graham@ed763
list the investment partners of Pre Seed Round - 24tidy	Daniel_Shi@4774b
list the investment partners of Private Equity Round - Zimmermann	Andrew_Ferrer@25c1d|Andrew_Crawford@75421
list the investment partners of Seed Round - Kira Talent	John_Albright@2cd93
list the investment partners of Pre Seed Round - Aquifer Motion	Amos_Schwartzfarb@2d0d1
list the investment partners of Debt Financing - LocaModa	Dave_Andonian@01164
list the investment partners of Series A - Axial Therapeutics	Jim_Blair@3f083|Michelle_Dipp@a2556
