what types of investor is Sharif El-Badawi	investment_partner|angel_investor
what types of investor is Robert Reeves	angel_investor
what types of investor is Eduardo Vivas	angel_investor
what types of investor is Dario Fazlic	angel_investor
what types of investor is Alexander Kritikos	angel_investor
what types of investor is Ajay Vashee	investment_partner|angel_investor
what types of investor is Deepak Maheshwari	investment_partner|angel_investor
what types of investor is Rob Durkin	angel_investor
what types of investor is Abhijit Pawar	angel_investor
what types of investor is Paul Posner	angel_investor
what types of investor is Daniel Burka	angel_investor
what types of investor is Abhishek Rungta	investment_partner|angel_investor
what types of investor is Barry Sternlicht	investment_partner|angel_investor
what types of investor is Chris Adamo	angel_investor
what types of investor is John Ryan	angel_investor
what types of investor is William Tunstall-Pedoe	angel_investor
what types of investor is Shantaram R	angel_investor
what types of investor is Geoff Levy AO	investment_partner|angel_investor
what types of investor is Marcus Seidel	angel_investor
what types of investor is Han Verstraete	angel_investor
what types of investor is Robert Sansom	investment_partner|angel_investor
what types of investor is Russell Parera	angel_investor
what types of investor is Elizabeth Hart	angel_investor
what types of investor is Dominik A. Lysek	angel_investor
what types of investor is Adelio Bollini	angel_investor
what types of investor is Dilyan Dimitrov	angel_investor
what types of investor is Jim Nichols	angel_investor
what types of investor is Elena Krasnoperova	angel_investor
what types of investor is Alexandre Martins	angel_investor
what types of investor is Jan Jannink	angel_investor
what types of investor is Jake Kendall	investment_partner|angel_investor
what types of investor is Ryan Howard	angel_investor
what types of investor is Pradip Madan	angel_investor
what types of investor is Jun Nishikawa	angel_investor
what types of investor is Enrico Vicentini	angel_investor
what types of investor is Tom Rogers	angel_investor
what types of investor is Gaurav Agarwal	angel_investor
what types of investor is Paul Grossinger	investment_partner|angel_investor
what types of investor is Geoff Entress	investment_partner|angel_investor
what types of investor is Pieter Abbeel	angel_investor
what types of investor is Gian Fulgoni	angel_investor
what types of investor is Patricia de loro le discot	angel_investor
what types of investor is Miguel Arias	investment_partner|angel_investor
what types of investor is Jari Ovaskainen	angel_investor
what types of investor is Yong Wang	angel_investor
what types of investor is Dennis Doane	angel_investor
what types of investor is Illés Szabolcs Dudás	angel_investor
what types of investor is Manish Bharti	angel_investor
what types of investor is Sean Byrnes	angel_investor
what types of investor is Sanford Dickert	angel_investor
what types of investor is Lea-Sophie Cramer	angel_investor
what types of investor is Peter Nesvold	investment_partner|angel_investor
what types of investor is Daniel Yates	angel_investor
what types of investor is Dorothy Jean Chang	angel_investor
what types of investor is Jen Rubio	angel_investor
what types of investor is Jay Goldberg	investment_partner|angel_investor
what types of investor is Juney Ham	angel_investor
what types of investor is Scott Goodson	angel_investor
what types of investor is Laura Grimmelmann	angel_investor
what types of investor is Rod Cuthbert	angel_investor
what types of investor is Zeljko Mataija	angel_investor
what types of investor is Raaj Kumar	angel_investor
what types of investor is Jerry Hausman	angel_investor
what types of investor is Greg Slamowitz	angel_investor
what types of investor is Clemente Germanetti	angel_investor
what types of investor is Ben Thompson	angel_investor
what types of investor is Manfred Krischke	angel_investor
what types of investor is Jon Reynolds	angel_investor
what types of investor is Robert Chew	investment_partner|angel_investor
what types of investor is Suman Dutta	angel_investor
what types of investor is Marcus Exall	angel_investor
what types of investor is Dhani Jones	angel_investor
what types of investor is Larry Bowman	angel_investor
what types of investor is Vijay Chattha	investment_partner|angel_investor
what types of investor is Patrick Preece	angel_investor
what types of investor is Maulik Majmudar	angel_investor
what types of investor is Adam Jiwan	angel_investor
what types of investor is James Qian	angel_investor
what types of investor is John W. Glynn	angel_investor
what types of investor is Peter O'Connell	angel_investor
what types of investor is Shane Donald	investment_partner|angel_investor
what types of investor is Didier Allaer	angel_investor
what types of investor is Marc Piette	angel_investor
what types of investor is Rich Newsome	angel_investor
what types of investor is Jacob Hsu	angel_investor
what types of investor is Hemanth Goteti	angel_investor
what types of investor is Freddie Fjelsted	angel_investor
what types of investor is Mazhar Alvi	angel_investor
what types of investor is Vikas Raj	investment_partner|angel_investor
what types of investor is Shawn Bercuson	angel_investor
what types of investor is Rajan Bajaj	angel_investor
what types of investor is Julia Collins	angel_investor
what types of investor is Bob Zipp	angel_investor
what types of investor is Kirsten Abma	angel_investor
what types of investor is Seth Bernstein	angel_investor
what types of investor is Jim Adamczyk	angel_investor
what types of investor is David Roux	investment_partner|angel_investor
what types of investor is Richard Clarke	angel_investor
what types of investor is Jonathan Quin	angel_investor
what types of investor is B. V. Jagadeesh	investment_partner|angel_investor
