gender of Yu-Chen Chang	male
gender of Thaddaeus Soh	male
gender of Matt Wray	male
gender of Guilherme Barros	male
gender of Joe Golden	male
gender of Gerardo Salandra	male
gender of Pierce Lehr	male
gender of Eoin Blacklock	male
gender of Mariusz Lasek	male
gender of Anna Kohnen	female
gender of Sandi Chanda	male
gender of Jignesh Savaliya	male
gender of Christopher Layton	male
gender of Trevor Seeley	male
gender of Benjamin Pitts	male
gender of Zach Weisman	male
gender of Xiaomin Mou	female
gender of Angela Littrell	female
gender of Ivan Komar	male
gender of Lauren Goff	female
gender of Ryan McNelley	male
gender of Janna Murgia	female
gender of Davy Lassagne	male
gender of Marcelo Kim	male
gender of Sebastien Adjiman	male
gender of Igor Marjanovic	male
gender of Yago Rivera	male
gender of Jeffrey Boardman	male
gender of Thomas Derosne	male
gender of Michael Rapoport	male
gender of Andrew Knight	male
gender of Taylor Wilson	male
gender of Ali Hill	male
gender of Peter Berger	male
gender of Larry Moore	male
gender of Hal Roberts	male
gender of Stephen Lark	male
gender of Falk Rehwagen	male
gender of Randy Levensalor	male
gender of Kenneth Schiciano	male
gender of Sean G. Simon	male
gender of Ana Abreu	female
gender of Pankaj Chandwani	male
gender of Ulises Estrada	male
gender of Brooke Brown	female
gender of Julia Koroliuk	female
gender of Jennifer Phillips	female
gender of Julie McAlinden	female
gender of Gabriela Soskuty	female
gender of Jaspar Eyears	male
gender of Ammon Brown	male
gender of Rick Harrison	male
gender of Ben Kerran	male
gender of Barry Kuo	male
gender of Ryan Smith	male
gender of Sam Balaji	male
gender of Maria Espaldon	female
gender of David Bergmann	male
gender of Ayana Elizabeth Johnson	female
gender of Sally Bament	female
gender of Steven Roncal	male
gender of Danny Kite	male
gender of Ivan Roitt	male
gender of Dominique x Romanowski	female
gender of Chris McDonnell	male
gender of Sanjay Krishnan	male
gender of Keven Doyle	male
gender of Torsten Nilsson	male
gender of Yochai Rozenblat	male
gender of Paul J Latour	male
gender of Kelly Sims	female
gender of Fred Johnson	male
gender of Monika Solanki	female
gender of Skye Von	female
gender of Tami Mohney	female
gender of Darcy Carstens	female
gender of Andrew Curland	male
gender of Ranjith Yengoti	male
gender of Tadashi Kuroiwa	male
gender of Ashish Lahoti	male
gender of Michael Applebaum	male
gender of Tigran Afrikyan	male
gender of Jason Cooper	male
gender of Stephen Pearce	male
gender of Yu Guo	male
gender of Daniel Wartolowski	male
gender of Michael Pusateri	male
gender of Eric Spiak	male
gender of Christian Young	male
gender of Edward Eatock	male
gender of Eric Bencomo	male
gender of Phyl Warnock	male
gender of Pratheesh Mahendran	male
gender of Marty Valente	male
gender of Rene Vidal	male
gender of Justin Mart	male
gender of Adnan Zaheer	male
gender of Nader Ale Ebrahim	male
gender of Abdurazak Mudesir	male
gender of Karmen Bradvica-MarohniÄ‡	female
