specialization of Power Systems Project & Consultancy Services	Construction
specialization of CooTek	Android|iOS|Mobile_Apps|Software|Natural_Language_Processing|Artificial_Intelligence
specialization of BeigePlus	Retail|Women's
specialization of Pasabi	Cyber_Security|Consumer_Reviews|E-Commerce|Artificial_Intelligence|Social_Media|Retail_Technology
specialization of reKindness	iOS|Fashion|E-Commerce|Social_Shopping|Consumer_Software|Apps
specialization of Codingal	EdTech|Education|STEM_Education
specialization of BuyMoreProduct	Commercial|B2B|Internet|E-Commerce
specialization of Yoga Wake Up	Fitness|Music|Apps
specialization of dinCloud	Enterprise_Software|Cloud_Computing|Security
specialization of Springboard Philippines	Information_Technology|Human_Resources|Software|Recruiting|Training|Education|Consulting
specialization of Guidotti Centro Stampa	Packaging_Services
specialization of Pretzel Labs	Gaming|Apps|Computer
specialization of Subsy	Human_Resources|Education
specialization of Crypto.IQ	Bitcoin|Cryptocurrency|Mobile_Payments
specialization of Preziosi Food srl	Manufacturing|Food_and_Beverage
specialization of IXD	Information_Technology|Security|Document_Management|Service_Industry|Messaging
specialization of Midland Medical Technologies	Health_Care|Medical
specialization of Innerspace Products	Health_Care
specialization of Global Shapers Community	Communities|Non_Profit|Young_Adults
specialization of OPtimAIze	Artificial_Intelligence
specialization of Portal da Queixa	Big_Data|Business_Intelligence|Consumer
specialization of INVL Baltic Sea Growth Fund	Business_Development
specialization of Rapid RMS	Cloud_Management|Retail|Retail_Technology|Software|Payments|Point_of_Sale
specialization of Epod	Advertising|Web_Hosting|E-Commerce
specialization of ZhiMei	Finance|Financial_Services|Consulting
specialization of InnovaReviews	Small_and_Medium_Businesses|Consumer_Reviews|E-Commerce
specialization of HATCHER+	FinTech|Venture_Capital|Artificial_Intelligence|Machine_Learning|Big_Data|Incubators
specialization of BCS Interactive	Software|Mobile_Apps|Advertising|Marketing
specialization of Welldoc	Diabetes|Health_Care|Wellness|Real_Time|Medical|Fitness|Therapeutics
specialization of ADI Strategies	Analytics|Information_Services|Information_Technology|Consulting
specialization of PDQuick	Delivery|Internet|Shopping|E-Commerce
specialization of X BODY	Developer_Platform|Therapeutics|Biotechnology
specialization of Ethika	Lifestyle|Fashion
specialization of ProductLed	Internet|Marketing
specialization of Rasa Life Science Informatics	Bioinformatics|Training|Life_Science
specialization of YourDMS	Software|Management_Consulting|Business_Intelligence|Document_Management
specialization of 2080 Media	Digital_Media|Events|Content
specialization of Rapid Prototyping Services	Product_Design|3D_Technology|3D_Printing
specialization of Collstream	SMS|Messaging|Public_Relations
specialization of Cash Management Solutions	Software|Outsourcing|Financial_Services
specialization of Green Tomorrow	Information_Technology
specialization of TechLink Insights	Mobile|Human_Resources|Health_Care|Education|Consulting
specialization of Shopconnect	Software|Enterprise_Software|Information_Technology|E-Commerce
specialization of Metabrain	Software|Hardware|Human_Computer_Interaction|Artificial_Intelligence|Neuroscience
specialization of Hirtenberger Engineered Surfaces	Industrial_Engineering
specialization of Morgan's Product	Personal_Health|E-Commerce|Cosmetics|Small_and_Medium_Businesses|Food_and_Beverage
specialization of Two Big Ears Ltd	Software|Audio|Consumer_Electronics|Virtual_Reality
specialization of DarikNews.bg	Media_and_Entertainment|Internet|News
specialization of Arquer Diagnostics	Health_Diagnostics|Health_Care|Medical_Device|Biotechnology
specialization of Bilhi Genetics	Health_Care|Genetics|Biotechnology
specialization of Spark	Internet|Advertising|Consulting
specialization of The IAFF Center of Excellence	Health_Care
specialization of InspiriaMedia Group	Advertising|Marketing
specialization of Ouedkniss	Classifieds|Advertising|E-Commerce
specialization of V-Guard Industries	Electrical_Distribution|Consumer_Electronics|Manufacturing
specialization of GoRemote Internet Communications, Inc	Mobile|Information_Technology|Software|Internet|Telecommunications|Communications_Infrastructure
specialization of Hipsters, Hackers & Hustlers	Communities|Collaboration|Events
specialization of Portfolio School	Education
specialization of The Ozone Project	Digital_Marketing|Publishing|Journalism|Advertising|Brand_Marketing|Marketing
specialization of MediaMob	Advertising|Marketing
specialization of France Rocks	Media_and_Entertainment|Online_Portals|Music|Internet
specialization of Goomi Technology	Software|Web_Development|Information_Technology
specialization of Theratogs	Health_Care|Medical
specialization of Metropolis Dialysis Services	Health_Diagnostics|Health_Care|Hospital
specialization of Apeiros	E-Commerce
specialization of Blic	Venture_Capital
specialization of Swiss Immo Lab	Venture_Capital|Real_Estate|FinTech|Construction
specialization of Soukai Drug	Marketing
specialization of WeRTeachers	E-Learning|Marketplace
specialization of Quaker BioVentures	Life_Science|Venture_Capital|Biotechnology
specialization of Wilderside Productions	Digital_Media
specialization of Bisco Bio Sciences	Manufacturing|Agriculture|Food_and_Beverage|Biotechnology
specialization of Cape Software	Software|Computer
specialization of Datlinq	Information_Technology|Sales|Advertising|Food_and_Beverage|Marketing|Information_Services
specialization of Mijian	Health_Care|Medical|Rehabilitation
specialization of Aradatum	Telecommunications|Communications_Infrastructure|Internet|Clean_Energy
specialization of Paceline Equity Partners	Service_Industry|Finance|Financial_Services
specialization of Hosting	SEO|Information_Technology|Web_Hosting
specialization of Everest Biomedical Instruments Company	Medical
specialization of Vivriti Capital	Marketplace|Financial_Services|Banking|Analytics|FinTech|Insurance|Crowdfunding
specialization of GEAR Innovation Network	Information_Technology
specialization of The Physical Therapy Connection	Health_Care
specialization of Spacely	Human_Resources|Consulting
specialization of Prism Digital	Information_Technology|Human_Resources|Digital_Media|Recruiting|Staffing_Agency|Social_Recruiting|Consulting
specialization of Trans Provincial Freight Carriers Limited	Transportation|Freight_Service
specialization of Intermestic	Manufacturing|Sales
specialization of E-Car Club	Car_Sharing|Automotive|E-Commerce|Autonomous_Vehicles|Leisure
specialization of MamaClean	Fashion|Retail|E-Commerce
specialization of British Assessment Bureau	Service_Industry|Business_Development
specialization of Coleen	Machinery_Manufacturing|Automotive|Manufacturing
specialization of Development Bank of Japan	Finance|Financial_Services|Business_Development|Banking
specialization of CELIA Motophone Ltd	Internet|Telecommunications|Computer
specialization of Select TV solutions LTD	Mobile|Internet|TV
specialization of Cheops Technology	Information_Technology|Information_Services|Consulting
specialization of ARAZOO	B2B|Interior_Design|Construction|Search_Engine
specialization of Shandong Caijin Touzi	Finance|Asset_Management|Consulting
specialization of Launch Tower Health	Health_Care
specialization of Prince Lobel	Consulting
specialization of Ricoto	Information_Technology|Education
specialization of Aquiline Drones	Commercial|Drones|Aerospace|Internet_of_Things
