country of Ilmenau Business Angels	DEU
country of Umicore Technical Materials North America Inc.	USA
country of Curler	ESP
country of Tejas Financial Advisors	USA
country of Waggit	USA
country of European Association for Local Development	BEL
country of Gamsole	NZL
country of Diamondback Works	USA
country of YUIMEX	JPN
country of Hillock Sports	USA
country of Borgolon	ITA
country of 3 Data	USA
country of TVM Capital	DEU
country of Aginic	AUS
country of Shield Safety Group	GBR
country of Use Peach	USA
country of Independent Bank	USA
country of Bottmedical	CHE
country of City Barbeque	USA
country of Bet Am Shalom Synagogue	USA
country of American Coradius International	USA
country of AC Chesters & Son	GBR
country of CSP Technologies	USA
country of CTeL	USA
country of GP Temporários	BRA
country of Villain	USA
country of 4K Garden	CHN
country of Netbrokers Holding	CZE
country of agent3	GBR
country of UCA	DEU
country of ASAHI TECH INDUSTRY	JPN
country of Sirtris Pharmaceuticals	USA
country of Sagenso	POL
country of Simply Served	USA
country of Hearst Connecticut Media Group	USA
country of Glassbox	GBR
country of GoodHabitz	NLD
country of CMO	JPN
country of Trygg Trafikk	NOR
country of Openr	GBR
country of True Value	USA
country of Adyen	NLD
country of Yuan Zhen Capital	CHN
country of Areti Internet	GBR
country of CarCharging	USA
country of Metta	GBR
country of Nutshell Therapeutics	CHN
country of Southwest Stone	USA
country of QS Pharma	USA
country of Navigant Solutions	USA
country of Aegon Asset Management	NLD
country of British Design Fund	GBR
country of Commons Capital	USA
country of Excelsior Technologies	GBR
country of Realpad	CZE
country of Jibo	USA
country of Wood Group Mustang	USA
country of TWG	CAN
country of Marketing Architects	USA
country of CariDerm Therapeutics	USA
country of Ábaco Latam	ESP
country of Century Wholesale	USA
country of B Cellars	USA
country of Hongrui Touzi	CHN
country of Werdenberg International Corporation	PHL
country of Abroadup	IND
country of Entresd	ESP
country of Startupbootcamp FinTech Cairo	EGY
country of Clerk	CHL
country of Yay Lunch	USA
country of VT Leasing	NGA
country of All4Labels - Global Packaging Group	DEU
country of National Crime Agency - NCA	GBR
country of Neil Patel Digital	USA
country of SecludIT	FRA
country of ShePlusPlus	USA
country of Lawrence Investments	USA
country of Westfield	ROM
country of Push2Start	USA
country of rezaur.net	BGD
country of Mirra	USA
country of Twin Ports Energy	USA
country of Common Garden	USA
country of Carillon Tower Advisers	USA
country of Make It Work	USA
country of Grobank	ZAF
country of Goodwillion	USA
country of Pingtan Marine Enterprise	CHN
country of Remington Outdoor - ammunition and accessories businesses	USA
country of U.S. Department of the Interior	USA
country of Forian	USA
country of QCR Holdings	USA
country of Advanced One Legal	USA
country of Golf Galaxy	USA
country of IBS Precision Engineering	NLD
country of Jeni's Ice Creams	USA
country of Chevia	USA
country of DHA Energy	USA
country of Electrolux	SWE
country of Pronoia	USA
