what kind of event is Google IO 2021	conference
what kind of event is Abilities Expo New York Metro 2015	conference|expo|demo_day
what kind of event is SF Enterprise Tech Meetup	meetup
what kind of event is World Congress on Recent Advances in Aquaculture Research & Fisheries	conference
what kind of event is Minting the Map and DAOs with Josh Williams and Dennis Crowley	meetup
what kind of event is .NET DeveloperDays 2019	conference
what kind of event is IoT Tech Expo Europe	expo
what kind of event is DeveloperWeek New York 2019	conference
what kind of event is How to Build a Successful Technology Startup	meetup
what kind of event is QS Connect MBA - Lisboa	conference
what kind of event is Landmark CIO Summit	conference
what kind of event is Embedded World 2016	conference|expo
what kind of event is 25th Annual Insurance Conference	conference
what kind of event is Connected Car Insurance Europe 2017	conference
what kind of event is Midsize Enterprise Summit Spring 2018	conference
what kind of event is AfroTalent Film Festival	festival
what kind of event is Smartsheet ENGAGE	conference
what kind of event is SuiteWorld 2017	expo
what kind of event is Tech Madness DC Competition Event	meetup|conference
what kind of event is WomenHack - San Francisco Employer Ticket 8/6	meetup|networking
what kind of event is APPSEC USA 2017	seminar|conference
what kind of event is Opportunity Hack	hackathon
what kind of event is NFV & Carrier SDN Automation & Monetization	conference
what kind of event is Chatbot Summit Tel Aviv 2019	conference
what kind of event is Green Canyon CBD	seminar
what kind of event is #WakandaRaise	meetup|conference|festival|virtual
what kind of event is 2015 5th International Conference on Information Communication and Management	conference
what kind of event is Defcamp	conference
what kind of event is Startup Weekend Aalborg 2017	meetup
what kind of event is TechFestNW 2021	competition|conference|expo
what kind of event is IBM InterConnect 2016	meetup|conference|networking|expo
what kind of event is Seattle Need to Know Seattle Startup Week	conference
what kind of event is Austin TechBreakfast	meetup
what kind of event is 2nd International Conference on Advanced Research (ICAR-Nov 2017)	conference
what kind of event is Preparing to Sell Your Dental Practice	seminar
what kind of event is Startup Weekend Pittsburgh	conference
what kind of event is Russia Energy Week International Forum 2021	conference
what kind of event is IANS Information Security Forum with CISO Shark Tank	conference
what kind of event is Texas Healthcare Challenge	hackathon
what kind of event is South by SouthWest 2019	competition|conference
what kind of event is Startup Grind Toronto Hosts Allen Lau	conference
what kind of event is Pioneers Festival 2014	festival
what kind of event is AgInvest2020	demo_day
what kind of event is An Introduction to Machine Learning in Healthcare, London	class
what kind of event is Seedstars Seoul	meetup
what kind of event is Natures Boost CBD Gummies	networking
what kind of event is Retail Ecommerce Breakfast + Conversation	conference
what kind of event is INDUSTRY: The Product Conference 2019	conference
what kind of event is Machine Learning Week Europe 2021	conference
what kind of event is WSJ D.Live Laguna 2017	conference
what kind of event is WordCamp Asia 2020	conference
what kind of event is Western Energy Institute Customer + Corporate Symposium	conference
what kind of event is BRITE 16	seminar|conference
"what kind of event is ASK THE EXPERTS: ""Onboarding digital: Que la distancia social no impida la incorporación de nuevos clientes"""	webinar
what kind of event is Triangle TechBreakfast featuring Tanjo, Disco Melee, GoSell Co., LockScreenIt	conference
what kind of event is Now and Next in Digital Assets	conference|networking
what kind of event is IMD CMO Roundtable 2019	conference
what kind of event is Kalicube Tuesdays with Jeff Coyle: The Risks and Rewards of AI-generated Content	webinar
what kind of event is HostingCon India 2016	seminar|conference
what kind of event is DatacenterDynamics Converged europe 2015	conference
what kind of event is Society3 Entrepreneurs Night - Funding in Silicon Valley Style Pitch Event	competition|meetup|networking
what kind of event is Cannabis CBD Gummies	seminar
what kind of event is The 5th SG-ANZICS Asia Pacific Intensive Care Forum	conference
what kind of event is Memphis Demo Day	demo_day
what kind of event is A Conversation With NerdWallet Cofounder: Lessons Learned and Advice for Founders	seminar|networking
what kind of event is gSchool Open House	conference
what kind of event is Chief Strategy Officer Summit Sydney 2018	conference
what kind of event is DerbyCon 2017	seminar|conference
what kind of event is IEEE 5G Summit San Diego	conference
what kind of event is Improve Your Budget Process With IDU	webinar
what kind of event is Transformative Technology Conference 2019	conference
what kind of event is DLD11	conference
what kind of event is Bern Startup Weekend	conference
what kind of event is Medical & Recreational Marijuana in California 2018	conference
what kind of event is Women's Startup Weekend San Francisco	conference
what kind of event is RSA Conference 2015	conference
what kind of event is HackerX - NYC (Back-End) Employer Ticket - 5/27	meetup|networking
what kind of event is Rails Israel 2015	conference
what kind of event is Responsible Innovation in Personal Data	conference
what kind of event is VIRTUAL - UNFILTERED: The Future of Fashion with Nell Diamond of Hill House Home	conference
what kind of event is HackerX Vienna (Wien) - [Full-Stack]	meetup|networking
what kind of event is Paying Tomorrow’s Workforce Today: Scaling Supply Side Payments in the On-Demand Economy	meetup|seminar|conference|networking
what kind of event is Inside WealthStack 2021	conference
what kind of event is New England Software Symposium 2015	conference
what kind of event is IT Arena 2017	conference|festival
"what kind of event is TTD ""Technologies for the Metropolis” 2021"	conference
what kind of event is Startup India Rocks 2015	festival
what kind of event is 200 Hour Yoga Teacher Training	class
what kind of event is Eagle Alpha - Simmons & Simmons - Data Monetization Seminar (Paris)	seminar
what kind of event is Ecosummit Berlin 2018	conference|networking
what kind of event is Open Source Summit Europe	conference
what kind of event is Network Virtualization and SDN Asia	conference
what kind of event is 2020 National Convention National Federation of the Blind	expo|virtual
what kind of event is Hack the Food System!	competition
what kind of event is SME Pitching Contest - SME Instrument EU Innovation Council	competition
what kind of event is Enfuse Conference 2017	conference
what kind of event is Asian Gaming Leaders Award	networking
what kind of event is Revolutionizing the Palm Oil Industry through IR 4.0 Forum 2019	seminar
what kind of event is Oktane16	conference
what kind of event is Startupbootcamp E-commerce Fasttrack Tel Aviv	meetup
