country of Lionel Wade	USA
country of Kazuki Kunimoto	JPN
country of R. Steve Kinsey	USA
country of Abbas Manjee	USA
country of Ishan .	IND
country of Art Hansen	USA
country of Jeffrey Brodzinski	USA
country of Skip Rung	USA
country of Lynda Marie Meador	USA
country of John Ives	USA
country of Bram Hechtkopf	USA
country of Ariel Elazar	USA
country of Ken Klein	USA
country of Allan Soave	USA
country of Jim Wilburn	USA
country of Cathy White	GBR
country of John Bunday	GBR
country of Maggie Liu	USA
country of Martin Krupauer	CZE
country of Andre Christ	DEU
country of Esteban Delgado	ESP
country of Piotr Dziubak	POL
country of Dhawal Bhanushali	IND
country of Subhomoy Samanta	IND
country of Thomas Zeutschler	DEU
country of Jarrett Taylor	USA
country of Sudhir Kandula	USA
country of Michael Serunian	USA
country of Joe Mastrorocco	USA
country of Christopher McCoy	USA
country of Mark Waldrep	USA
country of Ho Cho	USA
country of Rahil Sondhi	USA
country of John Mills	GBR
country of Tapio Anttila	FIN
country of Raj Tulsiani	GBR
country of Hyeonjin Ahn	KOR
country of Anil Madepalli	IND
country of Steve Michaelson	USA
country of Jamie Wright	USA
country of Asep Bagja Priandana	IDN
country of Robert Klijn	NLD
country of Scott Sbrocco	USA
country of David Demetrius	FRA
country of Sandra Schuster	DEU
country of Slawa Kister	DEU
country of Britta Butler	HKG
country of Zhicheng Bei	CHN
country of Mark Gillott	GBR
country of Corwin Carson	USA
country of Beatrice Tarka	USA
country of Jenna Hager	USA
country of Joanna McFarland	USA
country of Priya Iyengar	IND
country of Neil Goldman	USA
country of Brianna Welsh	USA
country of Sven Schulze	DEU
country of Paul Orlady	USA
country of Patrick Burns	USA
country of Dongzhu Wang	CHN
country of Geoff Peters	USA
country of Yuanfei Chen	CHN
country of Rey Cardenas	USA
country of Lena Jonsson	SWE
country of Bradley Grzesiak	USA
country of Tim Barrows	USA
country of Amy Stobie	GBR
country of Anneka Corveler	FRA
country of Venetia Lee	HKG
country of Julia Adler-Milstein	USA
country of Kunal Jhaveri	IND
country of Stacy Hoehle	USA
country of Paola Sapienza	USA
country of Jason Cross	USA
country of Jimmy Hsiao	TWN
country of Brady Jensen	USA
country of Jared Judge	USA
country of Fredrik Gustafsson	SWE
country of Spencer J. Malkin	USA
country of Mark Mahoney	USA
country of Daniyal Wali	PAK
country of Jun Nishiguchi	JPN
country of Diane Kegley	USA
country of Federico Segura	USA
country of Dominic Ely	GBR
country of Roger Norton	ZAF
country of Nigel Cox	AUS
country of Hassan Riggs	USA
country of Bernard Melloul	CAN
country of Craig Kinnison	USA
country of Idan Amir	ISR
country of Satish Pandey	IND
country of Karl G. Linder	DEU
country of Yash Sabharwal	USA
country of Tony DeYoung	USA
country of David Chen	USA
country of Rick Stevenson	AUS
country of Makoto Rheault-Kihara	CAN
country of Chris Vukelich	USA
country of Saif Khandaker	CAN
