roles of MetalsTech	company
roles of Hartford InsurTech Hub	investor
roles of Peckham Industries, Inc.	company
roles of DashScribe	company
roles of WellConnection	company
roles of Time Table, Inc.	company
roles of Carmichael Lynch	company
roles of Onboard	company
roles of Alacra	company
roles of RAI Care Centers of Southeast DC	company
roles of Venmetro	company
roles of ME2 Security	company
roles of CDL Omni-Pac	company
roles of Kidzopedia	company
roles of Gapminder VC	investor
roles of Engagor	company
roles of The 51 Ventures	investor|company
roles of nokisaki.com	company
roles of Dinghongxin Asset Management	investor
roles of DCG Technical Solutions, Inc.	company
roles of Adel	company
roles of Fichman Furniture	company
roles of Marcon Marketing Group	company
roles of Xtensegrity	company
roles of Alarys Home Health	company
roles of Aerogel Technologies	company
roles of Gangpiaoquan Cultural Communication	company
roles of Agora Media Ltd.	company
roles of Insurion	company
roles of Tengmao Xinxi Keji	investor
roles of Allot	company
roles of ED-Link	company
roles of cnvrg.io	company
roles of SmartBus	company
roles of Rack Centre	company
roles of North Point Outdoors	company
roles of 1% of Nothing	company
roles of Gran Plasa	investor
roles of Truist	investor|company
roles of Minibar Delivery	company
roles of Stockport Exploration	company
roles of Irell & Manella	company
roles of Solomon Solution	company
roles of BRIDGEGOOD	company
roles of CSI Medical	company
roles of Margdarshak	company
roles of Next Mountain	company
roles of Ontario Teachers' Pension Plan	investor
roles of BaNaPads	company
roles of PhyNexus	company
roles of Flux Accelerator	investor
roles of JenaValve Technology	company
roles of ChickRx	company
roles of Bharat Mentors	company
roles of Burlington Electric Department	company
roles of Rich Orthodontics	company
roles of Binary Lane	company
roles of Empulse	company
roles of Society of Broadcast Engineers	company
roles of 2POOD	company
roles of Lian Xing (Beijing) Zichan Guanli Youxian Gongsi	investor
roles of IPTEGO	company
roles of McKinsey Solutions	company
roles of Kucunyi	company
roles of Enquiries.co	company
roles of Nelsons Solicitors	company
roles of Framework Labs	company
roles of Aywa	company
roles of Buzly Labs	company
roles of Shenyang Jiushi Touzi	investor
roles of Opti-Logic	company
roles of PestconePlus	company
roles of Identitii	company
roles of apiphani	company
roles of Tarukino	company
roles of Amazee Group	company
roles of Minto Group	company
roles of Laburame	company
roles of GoSwiff	company
roles of MatchStar Venture Search	company
roles of London Life Insurance	company
roles of Anhui Fenglian Biotechnology	company
roles of Meduza	company
roles of LandWatch.com	company
roles of Orchard Mile	company
roles of XIAO LIU SOUP DUMPLING	company
roles of LiveTechnology Holdings, Inc.	company
roles of Labdoor	company
roles of La Machine	company
roles of Rx Securities	company
roles of Dental Marketing Experts	company
roles of Mocha7	company
roles of GitMate	company
roles of SmallSpark Space Systems	company
roles of Sage Care Ltd.	company
roles of StorPool	company
roles of Siiibo	company
roles of Eesports.net	company
roles of GE Digital Energy	investor|company
roles of MAD Square	company
