list of people who invested in Funding Round - Current Mobile	Kenzi_Wang@0e728
list of people who invested in Pre Seed Round - Big.Jobs	Sunder_Nookala@7b5db
list of people who invested in Series A - Cozy	Jason_Calacanis@21433
list of people who invested in Pre Seed Round - Ethale Books App	Miles_Morland@e7173
list of people who invested in Debt Financing - BEDROCK - Data by Design	Alex_Lawton@0f8ce
list of people who invested in Seed Round - AID:Tech	Jason_Calacanis@21433
list of people who invested in Equity Crowdfunding - Ampler Bikes	Madis_Müür@c63cb
list of people who invested in Seed Round - Infotainment Telepictures	Jovan_Hutton_Pulitzer@de91e
list of people who invested in Series C - Whisper	Jason_Calacanis@21433
list of people who invested in Private Equity Round - Infovys	Rohit_Dalvi@18a6c
list of people who invested in Seed Round - ecadema - Online Learning	Rahul_Mishra@57106
list of people who invested in Seed Round - REscour	Jason_Calacanis@21433
list of people who invested in Pre Seed Round - Musicasa	Arul_Murugan@ca928
list of people who invested in Series A - LeadGenius	Jason_Calacanis@21433
list of people who invested in Pre Seed Round - GrowValley	Jazeer_Jamal@ce236
list of people who invested in Pre Seed Round - Wizzywig	Jason_Calacanis@21433
list of people who invested in Seed Round - Betagig	Jason_Calacanis@21433
list of people who invested in Post-IPO Equity - Mynaric	Justin_Mateen@706cf
list of people who invested in Venture Round - Videopixie	Jason_Calacanis@21433
list of people who invested in Pre Seed Round - OndeCare	Lynn-Ann_Gries@f0be1
list of people who invested in Series A - Ringly	William_McClelland@be17e
list of people who invested in Seed Round - TopOPPS	Cliff_Holekamp@9cf88
list of people who invested in Seed Round - Reserve	Jason_Calacanis@21433
list of people who invested in Series A - Grove Collaborative	Josh_Mailman@82046
list of people who invested in Series B - Events.com	William_McClelland@be17e
list of people who invested in Seed Round - Benchmade Modern	Jason_Calacanis@21433
list of people who invested in Seed Round - GrowValley	Jazeer_Jamal@ce236
list of people who invested in Pre Seed Round - ecadema - Online Learning	Amin_Chaar@642d6
list of people who invested in Series C - CyCognito	Dan_Scheinman@62bb5
list of people who invested in Series A - blackshark.ai	Qasar_Younis@3f0ec
list of people who invested in Pre Seed Round - Statusphere	Jason_Calacanis@21433
list of people who invested in Private Equity Round - MIXX & Company	Bruno_R.F.@66e15
list of people who invested in Pre Seed Round - Ehubber	Uchechukwu_Ajuzieogu@43778
list of people who invested in Pre Seed Round - YAS	Yasmin_Shahin_Shaikh@d2315
list of people who invested in Series B - Anyword	Tomer_Tagrin@aeacc
list of people who invested in Pre Seed Round - 1ID	Faisal_Yasin@b5605
list of people who invested in Series A - Trove	Michael_Marks@ccfdb
list of people who invested in Seed Round - Stay Wanderful	Jason_Calacanis@21433
list of people who invested in Seed Round - Passionflix	Jason_Calacanis@21433
list of people who invested in Pre Seed Round - ePilot Mobility	Dennis_Weidner@4bd56
list of people who invested in Seed Round - Uniplaces	Rob_McClatchey@f7a27|Alexander_Edward_Chesterman@b68a4
list of people who invested in Seed Round - Space Nation	Omar_Rebhan@e652a
list of people who invested in Series A - Ascenty	Romero_Rodrigues@e8096
list of people who invested in Seed Round - Wunderkind (formerly BounceX)	Jason_Finger@a0f49
list of people who invested in Angel Round - Scandit	Ariel_Luedi@785fe
list of people who invested in Series A - Flash	Kevin_Efrusy@e8b34
list of people who invested in Series A - iPrice Group	Noel_Zeh@df3df
list of people who invested in Series A - OneDrop	Jason_Calacanis@21433
list of people who invested in Pre Seed Round - Myanmar Digital Solutions	Thet_Kyaw_Linn@0a7ea
list of people who invested in Series A - FinLocker	Cliff_Holekamp@9cf88
list of people who invested in Venture Round - Istegelsin	Yahya_Ülker@95dd6
list of people who invested in Debt Financing - Product Revolution Consulting	Daniel_O'Leary@70a8b
list of people who invested in Seed Round - Squirro	Alex_Ott@32e60
list of people who invested in Series A - Geoloqi	Brittney_Mickel@742e5
list of people who invested in Series A - Wunderkind (formerly BounceX)	Jason_Finger@a0f49
list of people who invested in Seed Round - Kush Marketplace	Jason_Calacanis@21433
list of people who invested in Pre Seed Round - Geopay.me	Antonis_Valamontes@d8d5a
list of people who invested in Series A - Sdui	David_Nothacker@b796e|Martin_Ostermayer@747ad|Udo_Schloemer@39b71|Nicolaus_Schefenacker@2c6f4|Julius_Koehler@88565|Dirk_Freise@c7bf0
list of people who invested in Series A - Internet Distribution Systems (IDS LLC.)	William_Kirby@4858a
list of people who invested in Seed Round - GeneDrop	Jonathan_Boutelle@09d9e
list of people who invested in Series B - Trove	Dan_Levitan@8592e
list of people who invested in Angel Round - GigIndia	Subramaniam_Ramadorai@cc4a5
list of people who invested in Seed Round - ProductionPro	Jason_Calacanis@21433
list of people who invested in Seed Round - vSure	Matt_Paff@0d61f
list of people who invested in Venture Round - COOL WATCH	Tuncay_TUNÇKOL@3257f
list of people who invested in Seed Round - P2Pseller	Oleg_Krot@a36dd|Yura_Lazebnikov@a507e
list of people who invested in Series A - Jointer	Brittney_Mickel@742e5
list of people who invested in Pre Seed Round - ecomo	Jason_Calacanis@21433
list of people who invested in Series B - Befundo.com	Michael_Maximilian_Sepp@7f628
list of people who invested in Pre Seed Round - HydraX Incorporation	Sagar_Ratilal_Bavarva@92b85
list of people who invested in Pre Seed Round - Underground Cellar	Jason_Calacanis@21433
list of people who invested in Seed Round - Auto Arremate	Fulvio_Kaminski_Massaro@3fd12
list of people who invested in Pre Seed Round - Geniuslink	Jason_Calacanis@21433
list of people who invested in Venture Round - PayRange	Jerry_Murdock@34c82
list of people who invested in Seed Round - Foom	Ishara_Yusdian@8c37d
list of people who invested in Series A - e.fundamentals	David_Murray-Hundley@b399c
list of people who invested in Pre Seed Round - Transported VR	Jason_Calacanis@21433
list of people who invested in Seed Round - Britcan Media Limited	John_Curtis@c924a
list of people who invested in Pre Seed Round - ClosedWon	Jason_Calacanis@21433
list of people who invested in Series A - Silent Circle	Ross_Perot@0dc46
list of people who invested in Series B - Yappli	Shogo_Kawada@3d6e1
list of people who invested in Venture Round - Packlink	Noel_Zeh@df3df
list of people who invested in Pre Seed Round - Steno	Arman_Assadi@ba178
list of people who invested in Seed Round - Level Travel	Pavel_Glushenkov@aa50d
list of people who invested in Seed Round - Swayable	Chris_Sacca@54639
list of people who invested in Convertible Note - Rocket.La	Patrick_Wakeham@e0cdc
list of people who invested in Seed Round - Pickaboo.com	Aminur_Rashid@70635
list of people who invested in Angel Round - Ali Rasoul LTD	Ali_Rasoul@9442c
list of people who invested in Seed Round - OneDrop	Jason_Calacanis@21433
list of people who invested in Series A - Splash	Jos_White@8effa
list of people who invested in Private Equity Round - Music Lover	Bav_Kong@f4297
list of people who invested in Pre Seed Round - Flutter	Jason_Calacanis@21433
list of people who invested in Seed Round - Charco Neurotech	Sayinthen_Vivekanantham@c828e
list of people who invested in Convertible Note - ProductionPro	Jason_Calacanis@21433
list of people who invested in Pre Seed Round - LÜK Network	Jason_Calacanis@21433
list of people who invested in Series C - Uber	Scott_Belsky@81cfe
list of people who invested in Pre Seed Round - TidyMarketer	Jason_Calacanis@21433
list of people who invested in Series C - Chartbeat	Jason_Calacanis@21433
list of people who invested in Series A - Virgin Hyperloop	Jason_Calacanis@21433
