Post-IPO Debt - Superior National Bank and Trust was launched in which country	USA
Series A - Coder was launched in which country	USA
Equity Crowdfunding - Ovanova was launched in which country	USA
Grant - Diurnal Group was launched in which country	GBR
Seed Round - OneWed (Formerly Nearlyweds) was launched in which country	USA
Seed Round - Material World was launched in which country	USA
Series A - Angel.ai was launched in which country	USA
Venture Round - NEPENTHEA was launched in which country	USA
Series B - Thirty Madison was launched in which country	USA
Venture Round - AxioMed Spine was launched in which country	USA
Seed Round - HexaHealth was launched in which country	IND
Series A - Affise was launched in which country	LTU
Debt Financing - Illumagear was launched in which country	USA
Seed Round - Upptalk was launched in which country	ESP
Series C - Blueheath Holdings was launched in which country	GBR
Seed Round - Clicknbox was launched in which country	MEX
Venture Round - Frame was launched in which country	GBR
Series B - Innovance was launched in which country	USA
Series B - Silicon Mobility was launched in which country	FRA
Seed Round - Machine2Learn was launched in which country	NLD
Grant - Portland State University was launched in which country	USA
Debt Financing - BrightSource Energy was launched in which country	USA
Venture Round - Valant was launched in which country	USA
Seed Round - amBX was launched in which country	GBR
Grant - Inklaw Clothing was launched in which country	ISL
Debt Financing - Comet Solutions was launched in which country	USA
Private Equity Round - Souq was launched in which country	ARE
Seed Round - DAD Technology Limited was launched in which country	GBR
Grant - Wall Colmonoy was launched in which country	USA
Series A - On-Q-ity was launched in which country	USA
Series B - Zameen.com was launched in which country	PAK
Grant - Suncayr was launched in which country	CAN
Debt Financing - Innocoll Holdings was launched in which country	USA
Series A - Vangard Voice Systems was launched in which country	USA
Series A - RFPIO Inc. was launched in which country	USA
Series B - Eureka Therapeutics was launched in which country	USA
Venture Round - Sasta Sundar was launched in which country	IND
Angel Round - Wangnian Keji was launched in which country	CHN
Angel Round - Modex, Inc. was launched in which country	USA
Series A - Michelle Kaufmann Designs was launched in which country	JPN
Seed Round - Mircod was launched in which country	USA
Seed Round - Pressed was launched in which country	USA
Series C - KSQ Therapeutics was launched in which country	USA
Debt Financing - Auxmoney was launched in which country	DEU
Corporate Round - Cerebrex was launched in which country	JPN
Seed Round - Talenz was launched in which country	SGP
Grant - 1337 was launched in which country	ISL
Series D - Roofstock was launched in which country	USA
Pre Seed Round - Baubap was launched in which country	MEX
Grant - Ormuco was launched in which country	CAN
Series A - Silofit was launched in which country	CAN
Convertible Note - TÃ­o Conejo was launched in which country	VEN
Grant - Hemolytics was launched in which country	CHE
Series A - netZentry was launched in which country	USA
Angel Round - 1Hulian was launched in which country	CHN
Venture Round - Greengage Lighting was launched in which country	GBR
Series B - Encover was launched in which country	USA
Venture Round - 1Kubator was launched in which country	FRA
Venture Round - KFx Medical was launched in which country	USA
Series B - Digitalsmiths was launched in which country	USA
Seed Round - DoneThing was launched in which country	IND
Series A - First Dollar was launched in which country	USA
Series A - Plenty was launched in which country	USA
Series B - Anaconda was launched in which country	USA
Angel Round - ControlSYS was launched in which country	CHN
Venture Round - Interactions was launched in which country	USA
Series A - Turnkey Lender was launched in which country	USA
Angel Round - Vembla was launched in which country	SWE
Seed Round - SchooLinks was launched in which country	USA
Seed Round - Orpyx Medical Technologies was launched in which country	CAN
Seed Round - Delfigo Security was launched in which country	USA
Debt Financing - Proxim Wireless was launched in which country	USA
Series B - Truekx was launched in which country	MEX
Seed Round - Slyp was launched in which country	AUS
Series B - Rainbow Hospitals was launched in which country	IND
Series A - Shadow was launched in which country	FRA
Series A - 90+ My Tuition App was launched in which country	IND
Debt Financing - ANDalyze was launched in which country	USA
Series A - Apieron was launched in which country	USA
Venture Round - TravelGuru was launched in which country	IND
Debt Financing - ASSURED PHARMACY was launched in which country	USA
Seed Round - Randori was launched in which country	USA
Series A - Evident.io was launched in which country	USA
Grant - Wooclap was launched in which country	BEL
Venture Round - Flyscan was launched in which country	CAN
Seed Round - Racetrack was launched in which country	IND
Series A - Level Access was launched in which country	USA
Venture Round - Distributed Solar Development was launched in which country	USA
Seed Round - PictureHealing was launched in which country	USA
Series A - Rossum was launched in which country	GBR
Series C - Convoq was launched in which country	USA
Seed Round - ClientDesk was launched in which country	CAN
Convertible Note - Threatcare was launched in which country	USA
Grant - TwingTec was launched in which country	CHE
Series C - Rally Software was launched in which country	USA
Pre Seed Round - Ellodee was launched in which country	USA
Series C - NewBiotics was launched in which country	USA
Angel Round - MicroEra Power was launched in which country	USA
Grant - Selux was launched in which country	USA
Debt Financing - Packet Design was launched in which country	USA
