FLINK alumni who has founded 2 or more companies	Henrik_Møller_Kristensen@6cfdf
DROdio Real Estate alumni who has founded 2 or more companies	Daniel_Odio@2afe7
Zipnosis alumni who has founded 2 or more companies	Ethan_Otterlei@91871
ShareLock Homes alumni who has founded 2 or more companies	Virender_Pratap_Singh@f3cbb
Cheerz alumni who has founded 3 or more companies	Nichola_Collinson@8ed86|Jane_Harvey@1da00
LiveWire Mobile alumni who has founded 2 or more companies	Mark_Grindeland@14fb2
Saatchi & Saatchi (Advertising Co.) alumni who has founded 2 or more companies	Joanne_Dai@63351
Hipster alumni who has founded 2 or more companies	Ethan_Czahor@df4f9
Eurotrade alumni who has founded 2 or more companies	Bo_Mattsson@7440a
The RPF Company alumni who has founded 2 or more companies	Jenny_Sutton@903d0
LearnVest alumni who has founded 2 or more companies	Andras_Forgacs@a1503
GF-X alumni who has founded 2 or more companies	Demetrios_Zoppos@ad22d
Matrimony.com alumni who has founded 2 or more companies	Alok_Mittal@333d0
École Polytechnique Fédérale de Lausanne alumni who has founded 3 or more companies	Sabine_Hauert@3b0f8
Pepsi Bottling Group alumni who has founded 2 or more companies	Wa'il_Ashshowwaf@83a18
Qashback Pte Ltd alumni who has founded 3 or more companies	Michael_Tan@9b243
Betable alumni who has founded 2 or more companies	Stefano_Bernardi@31150
Xtract alumni who has founded 3 or more companies	Jouko_Ahvenainen@6a98d
Declara alumni who has founded 2 or more companies	Ani_Chaudhuri@9f335
Ritz Camera & Image alumni who has founded 3 or more companies	Peter_Tahmin@70730
MobileDay alumni who has founded 2 or more companies	Dustin_Mallory@645f4
FirstMark alumni who has founded 2 or more companies	Sam_Hodges@21f20|Scott_Switzer@d43a5
Pop Products alumni who has founded 2 or more companies	Sam_Tassell@42176
Princeton Climate Analytics alumni who has founded 2 or more companies	Joseph_Studholme@aef76
Roland Berger alumni who has founded 2 or more companies	Andrea_Dusi@bc931
EVRYTHNG alumni who has founded 2 or more companies	Ari_Helgason@06c41
Kazaa alumni who has founded 2 or more companies	Niklas_Zennström@90d8f|Mick_Liubinskas@76778
Tappsi alumni who has founded 2 or more companies	Juan_Salcedo@3d036
Therosteon alumni who has founded 2 or more companies	Robert_AL@04808
Nuklius alumni who has founded 2 or more companies	Stefan_van_der_Fluit@1648d
SparkLabs Global Ventures alumni who has founded 2 or more companies	Net_Jacobsson@9021c
Vild alumni who has founded 2 or more companies	Marc_Emil_Domar@c5578
Modern Meadow alumni who has founded 2 or more companies	Andras_Forgacs@a1503
NiceChart alumni who has founded 2 or more companies	Dean_Weber@25f7b
Craft Coffee alumni who has founded 2 or more companies	Michael_Horn@1805e
Mark Burnett Productions alumni who has founded 2 or more companies	Rodney_Sampson@d4265
Dominican University of California alumni who has founded 2 or more companies	Paul_Bozzo@49be8
Vivotech alumni who has founded 2 or more companies	Kerry_Brown@b2dd4
Phononic alumni who has founded 2 or more companies	Matt_Trevithick@d24c4
Matter alumni who has founded 2 or more companies	Ben_Werdmuller@a8364
Pocket Change alumni who has founded 3 or more companies	Ari_Mir@2f4a0
Koach TV alumni who has founded 2 or more companies	Phillip_Chan@ac601|Derek_Yip@cc2c6
GlocalReach alumni who has founded 2 or more companies	Nicolai_Wadstrom@03ab7
Evercam alumni who has founded 2 or more companies	Vinnie_Quinn@72210
coComment alumni who has founded 2 or more companies	Nicolas_Dengler@9533f
Hot Potato alumni who has founded 2 or more companies	Jace_Cooke@33dcd
Atlassian alumni who has founded 2 or more companies	Haymo_Meran@971b0
ClipDis alumni who has founded 2 or more companies	Peter_Orban@3373f
Cambridge SamsungPartners alumni who has founded 7 or more companies	John_Donovan@1e4c8
Camba TV alumni who has founded 2 or more companies	Vinnie_Quinn@72210
eXaudios alumni who has founded 3 or more companies	Yoav_Hoshen@3d64e
Givatude alumni who has founded 2 or more companies	Rishad_Patel@6de3f
LocalSphere inc alumni who has founded 2 or more companies	Olivier_Vincent@10aca
HE:labs alumni who has founded 2 or more companies	Dirceu_Pauka_Jr.@6bb48
BExpert alumni who has founded 2 or more companies	Franz_Bories@1299b
Measure Map alumni who has founded 2 or more companies	Lane_Becker@95d80
Smartapps alumni who has founded 2 or more companies	Raphael_Pizzi@eefbf|Mariana_Vasconcelos@8e02d
Farasam alumni who has founded 2 or more companies	Hadi_Servat@51ffc
Elba Computer Systems alumni who has founded 2 or more companies	Kaan_Meralan@7a889
Tilting Point alumni who has founded 2 or more companies	Dan_Sherman@ecf4e
SoftIron alumni who has founded 3 or more companies	Norman_Fraser@c6c9d
Zazoom Media Group alumni who has founded 2 or more companies	Jay_DeDapper@ffafd
Daniel Goldner Architects alumni who has founded 3 or more companies	Jonathan_Slimak@c7715
Cogniciti alumni who has founded 2 or more companies	Charles_Plant@8488a
Novell alumni who has founded 3 or more companies	Toby_Corey@8591e
Hello Sitter alumni who has founded 2 or more companies	Suresh_Kalass@1a911
TRVL alumni who has founded 2 or more companies	Michel_Elings@2db00
Brix Networks alumni who has founded 2 or more companies	Nagarjuna_Venna@f2ad0
Boilerplate Inc. alumni who has founded 3 or more companies	Eric_Maguire@cd488
ArcSight alumni who has founded 2 or more companies	Anton_Goncharov@c0b12
FleteYa alumni who has founded 3 or more companies	Roberto_Coste_Ortega@62388
Artec Media alumni who has founded 2 or more companies	Adel_Zakout@2efe6
MedPointe Pharmaceuticals alumni who has founded 2 or more companies	James_S._Burns@33e49
Karmarama alumni who has founded 3 or more companies	Justine_Lassoff@2be88
UBS Investment Bank alumni who has founded 2 or more companies	Wouter_Kneepkens@e0a5a|Gaurav_Sharma@7fbea
2Wire alumni who has founded 3 or more companies	Brad_Kayton@c3970
CheckOne alumni who has founded 2 or more companies	Hwan_Kim@9a4db
ABeam Consulting alumni who has founded 2 or more companies	Jenny_Sutton@903d0
UrtheCast alumni who has founded 2 or more companies	Scott_Larson@ccfe6
ONEPROVE alumni who has founded 3 or more companies	Jakub_Krcmar@9f0c4
Vigilant Technology alumni who has founded 2 or more companies	Adi_Pinhas@d04f7
Ripio alumni who has founded 2 or more companies	Adriel_Araujo@c029c
Gatsby Social, Inc. alumni who has founded 2 or more companies	Dan_Abdinoor@aa14f
Assist AI alumni who has founded 2 or more companies	Roger_Fernandez_Guri@94b04
Conjecture Corporation alumni who has founded 2 or more companies	Denis_Grosz@0a0d9
CryoTherapeutics alumni who has founded 2 or more companies	Randy_Werneth@4a039
Integrum Technologies alumni who has founded 3 or more companies	Chris_Conrey@124d8
Peritus.ai alumni who has founded 2 or more companies	Mohan_Reddy@dbcc3
Digitas alumni who has founded 2 or more companies	Mark_Grindeland@14fb2
Virage Logic Corporation alumni who has founded 2 or more companies	Howard_Pakosh@0b2cb
TheraFlux Medical, Inc. alumni who has founded 2 or more companies	Shiv_Shukla@de6d2
Cambrian Genomics alumni who has founded 2 or more companies	George_Church@8a1af
RedOwl alumni who has founded 2 or more companies	Brian_Godsey@09370
Critical Links alumni who has founded 2 or more companies	Abdul_Kasim@1d96f
Rdio alumni who has founded 2 or more companies	Niklas_Zennström@90d8f
SMART VALOR alumni who has founded 2 or more companies	Jun_Gong@67160
Yelp alumni who has founded 2 or more companies	Gaurav_Ragtah@1f087
Payfully Corporation alumni who has founded 3 or more companies	Jonathan_Slimak@c7715
Partitona.com alumni who has founded 2 or more companies	Marco_Ogliengo@18240
MobOffer alumni who has founded 2 or more companies	Aji_Abraham@39fa8
