Meredith Stedman participated in what types of events	conference|expo
Zachariah Eslami participated in what types of events	meetup|conference|expo
Noah Malmstadt participated in what types of events	meetup|conference
Balaji Gopalan participated in what types of events	conference|festival
Sandeep Mathrani participated in what types of events	conference|festival
Giuseppe Monita participated in what types of events	seminar|networking
Guiomar Tunon participated in what types of events	networking|expo
Amy Brown participated in what types of events	seminar|conference|networking
Igor Serebryany participated in what types of events	conference|networking
Aya Miyaguchi participated in what types of events	meetup|conference
Richard Besser participated in what types of events	meetup|seminar|conference
Michael Rawlings participated in what types of events	conference|networking|expo
Adel ElMessiry participated in what types of events	conference
Leigh Honeywell participated in what types of events	conference
Josh Stein participated in what types of events	seminar|expo|competition|meetup|conference|networking
Anindya Ghose participated in what types of events	conference
Chris Nielsen participated in what types of events	conference|expo
Melanie Whelan participated in what types of events	expo|meetup|festival|conference|demo_day|networking
Andy Mathis participated in what types of events	seminar|conference
Ajay Kapoor participated in what types of events	conference
Sophia Lin participated in what types of events	conference
Catherine Allen participated in what types of events	seminar|conference
Paul Cheesbrough participated in what types of events	meetup|festival|conference|expo
Graham Christie participated in what types of events	conference|expo
Mimi Turner participated in what types of events	meetup|conference
Kurt Beecher Dammeier participated in what types of events	meetup|conference
Kristy McCann Flynn participated in what types of events	conference|networking
Sudha Biddinger participated in what types of events	meetup|conference
Heather Zhuang participated in what types of events	conference|networking
Brenda Choresi Carter participated in what types of events	meetup|conference|networking
Igor Barinov participated in what types of events	conference|expo
Nicole Adamson participated in what types of events	conference
Claus Aichinger participated in what types of events	meetup|conference|networking
Zach Robinson participated in what types of events	seminar|conference
Pramod Panda participated in what types of events	seminar|conference
Marcela Kane participated in what types of events	meetup|conference
Adam Golodner participated in what types of events	conference|expo
Simon Gisby participated in what types of events	conference|expo
Nanda Vijaydev participated in what types of events	conference
Enmanuel Toribio participated in what types of events	conference|networking
Kiara Graham participated in what types of events	conference
William Pugh participated in what types of events	conference|expo
Finbar O' Grady participated in what types of events	conference|expo
Alper Guler participated in what types of events	conference|expo
Varda Shalev participated in what types of events	conference|expo
Bob Wigley participated in what types of events	conference|festival
Lana Novikova participated in what types of events	seminar|expo|class|meetup|conference|networking
Graham Holt participated in what types of events	seminar|expo|demo_day|conference|networking
Josh Himwich participated in what types of events	conference
Ellie Young participated in what types of events	conference|networking|virtual
Chris Pearson participated in what types of events	seminar|conference|expo
Jornt van der Wiel participated in what types of events	seminar|conference
Anita Sands participated in what types of events	conference|networking
Wolfgang Bock participated in what types of events	conference
Yaron Vorona participated in what types of events	conference|networking
Claudiu Teodorescu participated in what types of events	conference|hackathon
Gabe McKenna participated in what types of events	meetup|competition|conference|networking
Ron Glozman participated in what types of events	conference
Bryan Cheng participated in what types of events	expo|class|meetup|conference|networking
Alex Tee participated in what types of events	conference|networking|expo
Sam Bhattarai participated in what types of events	conference|expo
Nathan Hall participated in what types of events	conference|expo
Brendan Ross participated in what types of events	conference|expo
Eric Benz participated in what types of events	seminar|expo|competition|meetup|conference|demo_day|hackathon
Philip Bolton participated in what types of events	meetup|conference
Stuart Law participated in what types of events	meetup|conference|networking
Ekaterina Skorobogatova participated in what types of events	meetup|festival|conference|expo
George Gilbert participated in what types of events	conference
Peter Falcone participated in what types of events	seminar|conference
Walter Wählt participated in what types of events	conference|hackathon
Chris Forman participated in what types of events	meetup|conference|networking
Chris Walls participated in what types of events	conference
Arup Barat participated in what types of events	conference|expo
Christoph Gerber participated in what types of events	conference|festival
Supriti Singh participated in what types of events	conference|expo
Francesco Agostinis participated in what types of events	seminar|conference
Jonathan Low participated in what types of events	competition|conference|networking|expo
Peter Lorenz participated in what types of events	seminar|conference
Clint Bodungen participated in what types of events	conference
Mark Miller participated in what types of events	conference|networking
Jay Kim participated in what types of events	seminar|expo|competition|conference|networking
Cory Deeter participated in what types of events	conference|expo
Todd Brady participated in what types of events	conference|expo
Jacqueline Gross participated in what types of events	seminar|conference
Barry Rafferty participated in what types of events	conference|expo
Narendra Naidu participated in what types of events	meetup|conference
Brian Gordon participated in what types of events	festival|conference|networking|expo
Eric Renaghan participated in what types of events	meetup|conference
Misha Hettie participated in what types of events	meetup|conference|expo
Frank Berry participated in what types of events	conference|networking
Petyo Budakov participated in what types of events	conference|expo
Liam Cleary participated in what types of events	seminar|class|conference|expo
Paris Addison participated in what types of events	expo|competition|meetup|conference|networking
Vladimir Pavlov participated in what types of events	competition|conference|networking
Fernando Machado participated in what types of events	seminar|conference|festival
Michael Pessina participated in what types of events	competition|meetup|conference|hackathon|demo_day|networking
Duncan Tickell participated in what types of events	meetup|networking
Jason Jercinovic participated in what types of events	conference|expo|festival
John Moloney participated in what types of events	conference|demo_day
Iván López participated in what types of events	conference
