what types of event did Rahul Gupta mostly participate in	conference|meetup
what types of event did Anders Drachen mostly participate in	meetup
what types of event did Philip Mountford mostly participate in	conference
what types of event did Rannia Leontaridi mostly participate in	conference
what types of event did Craig Heiting mostly participate in	demo_day|networking
what types of event did Michael Contreras mostly participate in	conference|networking
what types of event did Ong Geok Chwee mostly participate in	conference
what types of event did Charles Johnston mostly participate in	conference|demo_day|meetup|networking
what types of event did Joy Hawkins mostly participate in	conference
what types of event did Troy Witt mostly participate in	conference|expo
what types of event did Gwendolyn Regina mostly participate in	conference
what types of event did Darafei Praliaskouski mostly participate in	competition|conference|networking
what types of event did Shina Chung mostly participate in	competition|conference|demo_day|expo|meetup|networking|seminar
what types of event did Dinesh Malviya mostly participate in	conference|expo
what types of event did Arijana Walcott mostly participate in	conference|seminar
what types of event did Johnathan Teh mostly participate in	conference|expo|meetup|networking
what types of event did Scott Raney mostly participate in	conference
what types of event did Jen Wieczner mostly participate in	conference
what types of event did Andy Shenkler mostly participate in	conference
what types of event did Jason R. Sotero mostly participate in	conference
what types of event did Ishay Tentser mostly participate in	conference|seminar
what types of event did Meghann Dryer mostly participate in	competition|conference|expo|festival|networking|seminar
what types of event did Jason Tan mostly participate in	conference|expo
what types of event did Sebastian Titz mostly participate in	conference|meetup
what types of event did Paul Meister mostly participate in	conference|seminar
what types of event did Mike Krell mostly participate in	conference
what types of event did Michael Fritsch mostly participate in	conference
what types of event did John Allsopp mostly participate in	conference
what types of event did Mahangu Weerasinghe mostly participate in	conference|networking
what types of event did Billy Chasen mostly participate in	conference|hackathon
what types of event did Dermot Kelleher mostly participate in	conference|meetup
what types of event did Swasti Kakker mostly participate in	conference
what types of event did Paul Baran mostly participate in	conference|festival
what types of event did Mike Fitzmaurice mostly participate in	conference
what types of event did Ray Kloss mostly participate in	conference|seminar
what types of event did Mike Walsh mostly participate in	conference
what types of event did Haweya Mohamed mostly participate in	conference|meetup|networking
what types of event did Immo Rupf mostly participate in	conference|networking
what types of event did Christina Bodurow mostly participate in	conference|meetup
what types of event did Philipp Krenn mostly participate in	conference
what types of event did Jeff More mostly participate in	conference|meetup
what types of event did Yitz Fink mostly participate in	class|conference|expo|festival|hackathon|meetup|networking|seminar
what types of event did Kwame Andah mostly participate in	conference|meetup
what types of event did Babak Abedin mostly participate in	conference|festival
what types of event did Garrick Babel Dassi Dompie mostly participate in	competition|conference
what types of event did Ann Rockley mostly participate in	conference
what types of event did Grishma Jena mostly participate in	conference
what types of event did Dan Cook mostly participate in	conference|meetup|networking
what types of event did Laura Cammarota mostly participate in	conference|expo
what types of event did Lucie Brešová mostly participate in	conference|festival
what types of event did Christian Drehkopf mostly participate in	conference|expo
what types of event did Davide Ricci mostly participate in	conference
what types of event did Mark Nijmeijer mostly participate in	conference|expo
what types of event did Sam Scimemi mostly participate in	conference|seminar
what types of event did Sam Kherat mostly participate in	conference
what types of event did Giannina Caviezel mostly participate in	conference|expo|meetup|networking
what types of event did Jimmy Bogard mostly participate in	conference
what types of event did Claire Vyvyan mostly participate in	conference|expo
what types of event did Lawrence Wintermeyer mostly participate in	conference
what types of event did Anuj Gupta mostly participate in	conference|meetup
what types of event did Tom Conrad mostly participate in	conference|hackathon
what types of event did Rajat Agarwal mostly participate in	conference|expo|networking
what types of event did David Liang mostly participate in	conference|meetup
what types of event did Diarmuid Russell mostly participate in	conference|meetup|networking
what types of event did Marie Catherine Beuth mostly participate in	demo_day|expo|networking
what types of event did Mark Schreiber mostly participate in	conference|expo
what types of event did Bart De Vylder mostly participate in	conference
what types of event did Uri Minkoff mostly participate in	conference
what types of event did Brad Schaefbauer mostly participate in	conference
what types of event did Steve Fearn mostly participate in	expo
what types of event did Al Serino mostly participate in	conference|expo|networking
what types of event did Bulama Yusuf mostly participate in	conference
what types of event did Brian Burke mostly participate in	conference
what types of event did William Klippgen mostly participate in	competition|conference|networking|seminar
what types of event did Karen DiMeo mostly participate in	conference
what types of event did Jonathan Lacoste mostly participate in	conference
what types of event did Nic Williams mostly participate in	conference
what types of event did Peter Plester mostly participate in	conference|expo|networking|seminar|virtual
what types of event did James Harris mostly participate in	conference
what types of event did Heba Gamal mostly participate in	conference|meetup
what types of event did Sarah Frank mostly participate in	conference
what types of event did Peter Pupalaikis mostly participate in	conference|expo
what types of event did Liz Miller mostly participate in	conference|meetup|networking
what types of event did Susan Rossbach mostly participate in	competition|conference|expo
what types of event did Henrik Holland mostly participate in	conference
what types of event did Luke Sherwin mostly participate in	conference
what types of event did Joseph Mocanu mostly participate in	competition|conference|demo_day|expo|festival|meetup|networking|seminar
what types of event did Siobhan Dullea mostly participate in	conference
what types of event did Alvaro Gallego Martin mostly participate in	conference|seminar
what types of event did Brooke Wenig mostly participate in	conference
what types of event did Michael Dunn mostly participate in	conference|seminar
what types of event did Claude Abbou mostly participate in	conference|expo
what types of event did Breno Masi mostly participate in	conference|expo|festival|meetup
what types of event did Chirine Etezadzadeh mostly participate in	conference|expo|networking
what types of event did Joan Lesan mostly participate in	conference|seminar
what types of event did Carrie Kerpen mostly participate in	conference
what types of event did Simon Besteman mostly participate in	conference|festival
what types of event did Michael Yang mostly participate in	conference
what types of event did Sarah Toms mostly participate in	conference|meetup
what types of event did Carrie Lam mostly participate in	conference
