Scott Porter's job title	CTO
Summer Morton's job title	CTO
Catherine Connelly's job title	CTO
Tahseem Ahamd's job title	founder
Alexon Bell's job title	CTO
Jason Epstein's job title	founder
Matthew Rowe's job title	CTO
Ron Severdia's job title	CTO
Steve Newsome's job title	CTO
Shilpa Mydur's job title	CTO
Gareth Haines's job title	CTO
Elgin Edwards's job title	CTO|founder
Jiajie Wu's job title	CTO
Mika Meskanen's job title	CTO
Peter Svennilson's job title	CTO
Joanna Montgomery's job title	CTO
Pavel Belorusskiy's job title	CTO
Thiago Colares's job title	founder
John Jasan's job title	CTO
Shannon Falconer's job title	founder
Talia Mashiach's job title	CTO
Ofir Gal-On's job title	founder
Vince Rowe's job title	CTO
Cristina Sirbu's job title	CTO
Jane Niederberger's job title	CTO
Marcel Kooter's job title	CTO
Michael Traill's job title	CTO
Steve Hall's job title	CTO
Steve Beltz's job title	CTO
Gerald Diaz's job title	founder
Chua Tat-Seng's job title	CTO
Stephen Socolof's job title	CTO
Christopher Smith's job title	CTO
Lucian Mincu's job title	founder
Eric Bell's job title	CTO
Iain Hamilton's job title	CTO
Elina Berglund's job title	founder
Leon Rozenblit's job title	CTO
Nathan Evans's job title	founder
Markus Hörer's job title	CTO
Nakazawa Yuko's job title	CTO
Jack Mellor's job title	founder
Frank Warnsing's job title	CTO
Brigitte Small's job title	CTO|founder
David McLeod's job title	CTO
Denise Guilherme's job title	CTO
Andrew Doherty's job title	CTO
Falk Rehwagen's job title	CTO
Hanadi Jabado's job title	CTO
Vanessa Onnes's job title	CTO
Chris Brain's job title	CTO
Pablo Klestorny's job title	founder
Caroline Hazlehurst's job title	CTO
Marlene Vicaire's job title	CTO
Greg Evans's job title	CTO
Terry Taouss's job title	CTO
Steve Wilson's job title	CTO
Robert Blank's job title	founder
Neeraj Kakkar's job title	founder
Graham Wall's job title	CTO
Andy Katz's job title	CTO
Kate Heddleston's job title	CTO
Debbie Abravanel's job title	CTO
Carolyn Logan's job title	CTO
Lorenzo Pellicioli's job title	CTO
Mike Rockefeller's job title	founder
David Glaubke's job title	CTO
Clea O'hana's job title	founder
Travis R. Metz's job title	CTO
Ilan Hertz's job title	CTO
Junxiong Li's job title	CTO
Thomas Castro's job title	founder
Tor Braham's job title	CTO
Vikram Patel's job title	CTO
Emer Coleman's job title	CTO
Adheesh Thalekkara's job title	CTO
Olivier Aubert's job title	CTO
Jim Kane's job title	CTO
Borja Moreno de Los Rios's job title	founder
Ragino Sidhu's job title	CTO
Bleddyn Rees's job title	CTO
Aaron Ross's job title	founder
Iday Shanawaz's job title	CTO
Paul Browne's job title	CTO
Will Ochandarena's job title	CTO
Yohei Goto's job title	CTO
Giovanni Tesoriere's job title	CTO
David O'Reilly's job title	CTO
Joshua Tretakoff's job title	CTO
John Groetch's job title	CTO
Rebecca Corliss's job title	CTO
Christian Castellano's job title	CTO
Matthias Osthoff's job title	CTO
Erik Pfannmöller's job title	founder
Paulo Gustavo Silva Perrota Lopes's job title	CTO
Marek Jablonsky's job title	CTO
Sam Asher's job title	CTO
Cheung Yan's job title	CTO
Jared Hobbs's job title	founder
Arvind Singh's job title	CTO
