what is the stock exchange symbol of Genenta Science's ipo	nasdaq
what is the stock exchange symbol of Zhejiang SF Oilless Bearing's ipo	szse
what is the stock exchange symbol of Cardinal Financial Corporation's ipo	nasdaq
what is the stock exchange symbol of Be Free's ipo	nasdaq
what is the stock exchange symbol of Wuxi Online and Offline Communication Information Technology's ipo	szse
what is the stock exchange symbol of Immersive VR Education's ipo	lse
what is the stock exchange symbol of Tuya's ipo	nyse
what is the stock exchange symbol of De.Mem's ipo	asx
what is the stock exchange symbol of Ultimate Escapes's ipo	nyse
what is the stock exchange symbol of National Medical Health Card's ipo	nasdaq
what is the stock exchange symbol of SMIN ltda's ipo	bvmf
what is the stock exchange symbol of Sforza Enterprises's ipo	nasdaq
what is the stock exchange symbol of 3Com's ipo	nasdaq
what is the stock exchange symbol of Infinity Broadcasting's ipo	nyse
what is the stock exchange symbol of Eton Pharmaceuticals's ipo	nasdaq
what is the stock exchange symbol of Journal Communications's ipo	nyse
what is the stock exchange symbol of WANdisco's ipo	lse
what is the stock exchange symbol of PROREIT's ipo	cve
what is the stock exchange symbol of PROCEPT BioRobotics's ipo	nasdaq
what is the stock exchange symbol of Nutritional Growth Solutions's ipo	asx
what is the stock exchange symbol of Xinhua Sports & Entertainment's ipo	nasdaq
what is the stock exchange symbol of Oracle's ipo	nyse
what is the stock exchange symbol of Northern Tier Energy's ipo	nyse
what is the stock exchange symbol of HI Q WASON's ipo	nasdaq
what is the stock exchange symbol of Jenkon International's ipo	nasdaq
what is the stock exchange symbol of eBenX's ipo	nasdaq
what is the stock exchange symbol of Exact Sciences's ipo	nasdaq
what is the stock exchange symbol of Cascal's ipo	nyse
what is the stock exchange symbol of NetSolve's ipo	nasdaq
what is the stock exchange symbol of Airbnb's ipo	nasdaq
what is the stock exchange symbol of KITS's ipo	tsx
what is the stock exchange symbol of The Keith Companies's ipo	nasdaq
what is the stock exchange symbol of Energous Corporation's ipo	nasdaq
what is the stock exchange symbol of Arco Educacao's ipo	nasdaq
what is the stock exchange symbol of Zuoan Fashion Limited's ipo	nyse
what is the stock exchange symbol of xTV Networks's ipo	asx
what is the stock exchange symbol of Aztec Minerals's ipo	cve
what is the stock exchange symbol of Allakos's ipo	nasdaq
what is the stock exchange symbol of Copano Energy's ipo	nasdaq
what is the stock exchange symbol of Lakala's ipo	szse
what is the stock exchange symbol of The Trade Desk's ipo	nasdaq
what is the stock exchange symbol of Tableau's ipo	nyse
what is the stock exchange symbol of Kinnate Biopharma's ipo	nasdaq
what is the stock exchange symbol of Home Federal Bancorp's ipo	nasdaq
what is the stock exchange symbol of Luna Innovations's ipo	nasdaq
what is the stock exchange symbol of EVERTEC's ipo	nyse
what is the stock exchange symbol of Greater Atlantic Financial's ipo	nasdaq
what is the stock exchange symbol of Fluidra Accelera's ipo	bme
what is the stock exchange symbol of Global Brass and Copper Holdings's ipo	nyse
what is the stock exchange symbol of Akero Therapeutics's ipo	nasdaq
what is the stock exchange symbol of Anadys's ipo	nasdaq
what is the stock exchange symbol of Tierone's ipo	nasdaq
what is the stock exchange symbol of Dominion Global's ipo	bme
what is the stock exchange symbol of Nofar Energy's ipo	tlv
what is the stock exchange symbol of Hortonworks's ipo	nasdaq
what is the stock exchange symbol of TaiGen Biotechnology's ipo	tsec
what is the stock exchange symbol of 2U's ipo	nasdaq
what is the stock exchange symbol of 111, Inc.'s ipo	nasdaq
what is the stock exchange symbol of Chuy's Holdings's ipo	nasdaq
what is the stock exchange symbol of Hudson Group's ipo	nyse
what is the stock exchange symbol of Towne Services's ipo	nasdaq
what is the stock exchange symbol of Medidata Solutions's ipo	nasdaq
what is the stock exchange symbol of HCpect's ipo	szse
what is the stock exchange symbol of Crexus Investment's ipo	nse
what is the stock exchange symbol of Sealy's ipo	nyse
what is the stock exchange symbol of AvidXchange's ipo	nasdaq
what is the stock exchange symbol of Odyssey Healthcare's ipo	nasdaq
what is the stock exchange symbol of Phoenix Companies's ipo	nyse
what is the stock exchange symbol of Zentalis Pharmaceuticals's ipo	nasdaq
what is the stock exchange symbol of Party City's ipo	nyse
what is the stock exchange symbol of Life Sense's ipo	szse
what is the stock exchange symbol of Vericel Corp's ipo	nasdaq
what is the stock exchange symbol of Calnex Solutions's ipo	lse
what is the stock exchange symbol of Tara Chand Logistic Solutions's ipo	nse
what is the stock exchange symbol of Real Good Foods's ipo	nasdaq
what is the stock exchange symbol of Sabre Corporation's ipo	nasdaq
what is the stock exchange symbol of Matterport's ipo	nasdaq
what is the stock exchange symbol of Livongo's ipo	nasdaq
what is the stock exchange symbol of Flexible Solutions International's ipo	nysemkt
what is the stock exchange symbol of PomVom's ipo	tlv
what is the stock exchange symbol of Footasylum's ipo	lse
what is the stock exchange symbol of Duolingo's ipo	nasdaq
what is the stock exchange symbol of NetRadio's ipo	nasdaq
what is the stock exchange symbol of JEE's ipo	sse
what is the stock exchange symbol of ESSA Bancorp's ipo	nasdaq
what is the stock exchange symbol of Hyperfine's ipo	nasdaq
what is the stock exchange symbol of Pansoft's ipo	nasdaq
what is the stock exchange symbol of iPower's ipo	nasdaq
what is the stock exchange symbol of Array Networks's ipo	tpe
what is the stock exchange symbol of MediaLink Worldwide's ipo	nasdaq
what is the stock exchange symbol of Karda Construction's ipo	nse
what is the stock exchange symbol of Avanex's ipo	nasdaq
what is the stock exchange symbol of Atea Pharmaceuticals's ipo	nasdaq
what is the stock exchange symbol of Nuvoco's ipo	nse
what is the stock exchange symbol of Goedeker's's ipo	nyse
what is the stock exchange symbol of Brookfield Renewable Partners's ipo	nyse
what is the stock exchange symbol of Ford Motor Co Capital Trust's ipo	nyse
what is the stock exchange symbol of IndoStar Capital's ipo	bom
what is the stock exchange symbol of Game Hollywood's ipo	hkg
what is the stock exchange symbol of Udemy's ipo	nasdaq
