GT Technologies had what types of acquisitions	merge
Pine Tree Equity had what types of acquisitions	lbo
Legacy Capital Group had what types of acquisitions	merge
Aihuishou had what types of acquisitions	merge
Skyline Venture Partners had what types of acquisitions	management_buyout
Mentorama had what types of acquisitions	merge
Silver Investment Partners had what types of acquisitions	lbo
Hyperink had what types of acquisitions	acquihire
InnovaFonds had what types of acquisitions	lbo|management_buyout
Kairos Capital Management had what types of acquisitions	lbo
Vanta Education had what types of acquisitions	lbo
CrowdVision had what types of acquisitions	merge
JP Morgan had what types of acquisitions	lbo
LNK Partners had what types of acquisitions	lbo
Mic had what types of acquisitions	lbo
Archstone Investment had what types of acquisitions	lbo
The Ascent Group had what types of acquisitions	lbo
Resource Innovations had what types of acquisitions	merge
KeyBanc Capital Markets had what types of acquisitions	lbo
Technokriti Solutions had what types of acquisitions	merge
Leonard Green & Partners had what types of acquisitions	lbo
X4 Pharmaceuticals had what types of acquisitions	merge
Montagu Private Equity had what types of acquisitions	lbo|management_buyout
PayScale had what types of acquisitions	merge
ZoomLean had what types of acquisitions	acquihire
Eclipx Group had what types of acquisitions	merge
Aspiriant had what types of acquisitions	merge
Kazoo had what types of acquisitions	merge
Cathay Capital had what types of acquisitions	lbo
Cinelab London had what types of acquisitions	merge
Just Eat had what types of acquisitions	merge
HerbalGem had what types of acquisitions	merge
McKinsey & Company had what types of acquisitions	acquihire
OneSavings Bank had what types of acquisitions	merge
RMB Capital had what types of acquisitions	lbo
Dotdash had what types of acquisitions	acquihire
MPC Capital had what types of acquisitions	lbo
Cambridge Trust Company had what types of acquisitions	merge
Linus Health had what types of acquisitions	merge
Heritage Financial Corp had what types of acquisitions	acquihire
Churchill Capital Corp IV had what types of acquisitions	merge
Ironbridge Equity Partners had what types of acquisitions	lbo
Cabot Oil & Gas Corporation had what types of acquisitions	merge
EverBridge had what types of acquisitions	acquihire
Turning had what types of acquisitions	merge
Banneker Partners had what types of acquisitions	lbo
Tiny Capital had what types of acquisitions	lbo
Accent Equity Partners had what types of acquisitions	lbo|management_buyout
Fondations Capital had what types of acquisitions	lbo
ORIX Group had what types of acquisitions	lbo
InHouse Ventures had what types of acquisitions	lbo
Investors Bancorp had what types of acquisitions	merge
Banker Steel had what types of acquisitions	lbo
MACH Capital had what types of acquisitions	lbo
VinaCapital Investment Management had what types of acquisitions	lbo
Punter Southall Aspire had what types of acquisitions	acquihire
Cathay Capital Private Equity had what types of acquisitions	lbo
Karmijn Kapitaal had what types of acquisitions	lbo|management_buyout
Linq had what types of acquisitions	merge
Fulcrum Capital Partners had what types of acquisitions	lbo
TPG Real Estate had what types of acquisitions	lbo
Clearwater Paper had what types of acquisitions	merge
Quad Partners had what types of acquisitions	lbo
Summer Street Capital Partners had what types of acquisitions	lbo
Bloom Equity Partners had what types of acquisitions	lbo
Activa Capital had what types of acquisitions	lbo|management_buyout
#digirockstars had what types of acquisitions	lbo
Prüvit had what types of acquisitions	merge
Qello had what types of acquisitions	merge
Yasui Seiki had what types of acquisitions	merge
Hudson’s Bay Company had what types of acquisitions	merge
Ryan Specialty Group had what types of acquisitions	merge
VIA Equity had what types of acquisitions	lbo
palero capital had what types of acquisitions	lbo
Blackstone Credit had what types of acquisitions	lbo
Barracuda Networks had what types of acquisitions	acquihire
MSouth Equity Partners had what types of acquisitions	lbo|management_buyout
Broadtree Partners had what types of acquisitions	lbo
Optimere (ArchiveSocial + Monsido + NextRequest) had what types of acquisitions	merge
HeadWater Equity Partners had what types of acquisitions	lbo
Aizu Doken had what types of acquisitions	merge
GIC had what types of acquisitions	lbo
ForwardPMX had what types of acquisitions	merge
Cantata Technology had what types of acquisitions	merge
WhiteWater Express Car Wash had what types of acquisitions	merge
Le VPN had what types of acquisitions	merge
Instinctif Partners had what types of acquisitions	lbo
Peak Rock Capital had what types of acquisitions	lbo|management_buyout
Kassel Equity Group had what types of acquisitions	lbo
Menden Ventures Consulting had what types of acquisitions	lbo
Stonehenge Partners Inc. had what types of acquisitions	lbo
NextView Capital had what types of acquisitions	lbo
Oncotelic Therapeutics had what types of acquisitions	merge
Sustainable Marine Energy had what types of acquisitions	merge
Oxford Investment Group had what types of acquisitions	lbo
McIntosh Perry had what types of acquisitions	merge
Charme Capital Partners had what types of acquisitions	lbo
Telemos Capital had what types of acquisitions	lbo
Nisela Capital had what types of acquisitions	lbo
Kohlberg Kravis Roberts had what types of acquisitions	lbo|management_buyout
